你		nǐ 	you (informal, as opposed to courteous 您)
好		hǎo <br /><br />hào 	good  / well  / proper  / good to  / easy to  / very  / so  / (suffix indicating completion or readiness)  / (of two people) close  / on intimate terms<br /><br />to be fond of  / to have a tendency to  / to be prone to
再见	再見	zài jiàn 	goodbye  / see you again later
再		zài 	again  / once more  / re-  / second  / another  / then (after sth, and not until then)
见	見	jiàn <br /><br />xiàn 	to see  / to meet  / to appear (to be sth)  / to interview<br /><br />to appear  / also written 現｜现
三		Sān <br /><br />sān 	surname San<br /><br />three  / 3
一		yī 	one  / 1  / single  / a (article)  / as soon as  / entire  / whole  / all  / throughout  / "one" radical in Chinese characters (Kangxi radical 1)  / also pr. [yao1] for greater clarity when spelling out numbers digit by digit
七		qī 	seven  / 7
八		bā 	eight  / 8
十		shí 	ten  / 10
零		líng 	zero  / nought  / zero sign  / fractional  / fragmentary  / odd (of numbers)  / (placed between two numbers to indicate a smaller quantity followed by a larger one)  / fraction  / (in mathematics) remainder (after division)  / extra  / to wither and fall  / to wither
元		Yuán <br /><br />yuán 	surname Yuan  / the Yuan or Mongol dynasty (1279-1368)<br /><br />currency unit (esp. Chinese yuan)  / first  / original  / primary  / fundamental  / constituent  / part  / era (of a reign)  / meta- (prefix)  / (math.) argument  / variable  / (Tw) (geology) eon
五		wǔ 	five  / 5
九		jiǔ 	nine  / 9
百		Bǎi <br /><br />bǎi 	surname Bai<br /><br />hundred  / numerous  / all kinds of
二		èr 	two  / 2  / (Beijing dialect) stupid
四		sì 	four  / 4
六		liù 	six  / 6
叫		jiào 	to shout  / to call  / to order  / to ask  / to be called  / by (indicates agent in the passive mood)
我		wǒ 	I  / me  / my
张	張	Zhāng <br /><br />zhāng 	surname Zhang<br /><br />to open up  / to spread  / sheet of paper  / classifier for flat objects, sheet  / classifier for votes
李		Lǐ <br /><br />lǐ 	surname Li<br /><br />plum
华	華	Huá <br /><br />Huà <br /><br />huá 	abbr. for China<br /><br />Mt Hua 華山｜华山 in Shaanxi  / surname Hua<br /><br />magnificent  / splendid  / flowery
明		Míng <br /><br />míng 	Ming Dynasty (1368-1644)  / surname Ming  / Ming (c. 2000 BC), fourth of the legendary Flame Emperors, 炎帝 descended from Shennong 神農｜神农 Farmer God<br /><br />bright  / opposite: dark 暗 / (of meaning) clear  / to understand  / next  / public or open  / wise  / generic term for a sacrifice to the gods
名字		míng zi 	name (of a person or thing)  / CL: 個｜个
什么	什麼	shén me 	what?  / something  / anything
名		míng 	name  / noun (part of speech)  / place (e.g. among winners)  / famous  / classifier for people
字		zì 	letter  / symbol  / character  / word  / CL: 個｜个 / courtesy or style name traditionally given to males aged 20 in dynastic China
什		shén <br /><br />shí 	what<br /><br />ten (used in fractions, writing checks etc)  / assorted  / miscellaneous
么	麼	má <br /><br />ma <br /><br />me 	exclamatory final particle<br /><br />interrogative final particle<br /><br />suffix, used to form interrogative 甚麼｜什么, what?, indefinite 這麼｜这么 thus, etc
姓		xìng 	family name  / surname  / CL: 個｜个 / to be surnamed
王		Wáng <br /><br />wáng <br /><br />wàng 	surname Wang<br /><br />king or monarch  / best or strongest of its type  / grand  / great<br /><br />to rule  / to reign over
呢		ne <br /><br />ní 	particle indicating that a previously asked question is to be applied to the preceding word ("What about ...?", "And ...?")  / particle for inquiring about location ("Where is ...?")  / particle signaling a pause, to emphasize the preceding words and allow the listener time to take them on board ("ok?", "are you with me?")  / (at the end of a declarative sentence) particle indicating continuation of a state or action  / particle indicating strong affirmation<br /><br />woolen material
李		Lǐ <br /><br />lǐ 	surname Li<br /><br />plum
很		hěn 	(adverb of degree)  / quite  / very  / awfully
高兴	高興	gāo xìng 	happy  / glad  / willing (to do sth)  / in a cheerful mood
高		Gāo <br /><br />gāo 	surname Gao<br /><br />high  / tall  / above average  / loud  / your (honorific)
兴	興	Xīng <br /><br />xīng <br /><br />xìng 	surname Xing<br /><br />to rise  / to flourish  / to become popular  / to start  / to encourage  / to get up  / (often used in the negative) to permit or allow (dialect)  / maybe (dialect)<br /><br />feeling or desire to do sth  / interest in sth  / excitement
认识	認識	rèn shi 	to know  / to recognize  / to be familiar with  / to get acquainted with sb  / knowledge  / understanding  / awareness  / cognition
也		Yě <br /><br />yě 	surname Ye<br /><br />also  / too  / (in Classical Chinese) final particle implying affirmation
认	認	rèn 	to recognize  / to know  / to admit
识	識	shí <br /><br />zhì 	to know  / knowledge  / Taiwan pr. [shi4]<br /><br />to record  / to write a footnote
吃		chī 	to eat  / to consume  / to eat at (a cafeteria etc)  / to eradicate  / to destroy  / to absorb  / to suffer  / to stammer (Taiwan pr. for this sense is [ji2])
饭	飯	fàn 	food  / cuisine  / cooked rice  / meal  / CL: 碗, 頓｜顿
鱼	魚	Yú <br /><br />yú 	surname Yu<br /><br />fish  / CL: 條｜条, 尾
面		miàn <br /><br />miàn 	face  / side  / surface  / aspect  / top  / classifier for flat surfaces such as drums, mirrors, flags etc<br /><br />flour  / noodles  / (of food) soft (not crunchy)  / (slang) (of a person) ineffectual  / spineless
喝		hē <br /><br />hè 	to drink  / My goodness!<br /><br />to shout loudly
水		Shuǐ <br /><br />shuǐ 	surname Shui<br /><br />water  / river  / liquid  / beverage  / additional charges or income  / (of clothes) classifier for number of washes
茶		chá 	tea  / tea plant  / CL: 杯, 壺｜壶
不		bù 	(negative prefix)  / not  / no
是		shì 	is  / are  / am  / yes  / to be
他		tā 	he or him  / (used for either sex when the sex is unknown or unimportant)  / (used before sb's name for emphasis)  / (used as a meaningless mock object)  / other  / another
学生	學生	xué sheng 	student  / schoolchild
学	學	xué 	to learn  / to study  / to imitate  / science  / -ology
生		shēng 	to be born  / to give birth  / life  / to grow  / raw  / uncooked  / student
吗	嗎	mǎ <br /><br />ma 	see 嗎啡｜吗啡, morphine<br /><br />(question particle for "yes-no" questions)
她		tā 	she
你们	你們	nǐ men 	you (plural)
我们	我們	wǒ men 	we  / us  / ourselves  / our
他们	他們	tā men 	they
们	們	men 	plural marker for pronouns, and nouns referring to individuals
老师	老師	lǎo shī 	teacher  / CL: 個｜个, 位
医生	醫生	yī shēng 	doctor  / CL: 個｜个, 位, 名
她们	她們	tā men 	they  / them (for females)
老		lǎo 	prefix used before the surname of a person or a numeral indicating the order of birth of the children in a family or to indicate affection or familiarity  / old (of people)  / venerable (person)  / experienced  / of long standing  / always  / all the time  / of the past  / very  / outdated  / (of meat etc) tough
师	師	Shī <br /><br />shī 	surname Shi<br /><br />teacher  / master  / expert  / model  / army division  / (old) troops  / to dispatch troops
医	醫	yī 	medical  / medicine  / doctor  / to cure  / to treat
的		de <br /><br />dī <br /><br />dí <br /><br />dì 	of  / ~'s (possessive particle)  / (used after an attribute)  / (used to form a nominal expression)  / (used at the end of a declarative sentence for emphasis)<br /><br />see 的士<br /><br />really and truly<br /><br />aim  / clear
电话	電話	diàn huà 	telephone  / CL: 部 / phone call  / CL: 通 / phone number
电	電	diàn 	electric  / electricity  / electrical
话	話	huà 	dialect  / language  / spoken words  / speech  / talk  / words  / conversation  / what sb said  / CL: 種｜种, 席, 句, 口, 番
号码	號碼	hào mǎ 	number  / CL: 堆, 個｜个
多少		duō shǎo <br /><br />duō shao 	number  / amount  / somewhat<br /><br />how much  / how many  / which (number)  / as much as
多		duō 	many  / much  / often  / a lot of  / numerous  / more  / in excess  / how (to what extent)  / multi-  / Taiwan pr. [duo2] when it means "how"
少		shǎo <br /><br />shào 	few  / less  / to lack  / to be missing  / to stop (doing sth)  / seldom<br /><br />young
号	號	háo <br /><br />hào 	roar  / cry  / CL: 個｜个<br /><br />ordinal number  / day of a month  / mark  / sign  / business establishment  / size  / ship suffix  / horn (wind instrument)  / bugle call  / assumed name  / to take a pulse  / classifier used to indicate number of people
码	碼	mǎ 	weight  / number  / code  / to pile  / to stack  / classifier for length or distance (yard), happenings etc
中国	中國	Zhōng guó 	China
人		rén 	man  / person  / people  / CL: 個｜个, 位
中		Zhōng <br /><br />zhōng <br /><br />zhòng 	China  / Chinese  / surname Zhong<br /><br />within  / among  / in  / middle  / center  / while (doing sth)  / during  / (dialect) OK  / all right<br /><br />to hit (the mark)  / to be hit by  / to suffer  / to win (a prize, a lottery)
国	國	Guó <br /><br />guó 	surname Guo<br /><br />country  / nation  / state  / national  / CL: 個｜个
哪		nǎ <br /><br />na <br /><br />něi 	how  / which<br /><br />(particle equivalent to 啊 after noun ending in -n)<br /><br />which? (interrogative, followed by classifier or numeral-classifier)
英国	英國	Yīng guó 	United Kingdom 聯合王國｜联合王国 / United Kingdom of Great Britain and Northern Ireland  / abbr. for England 英格蘭｜英格兰
美国	美國	Měi guó 	United States  / USA  / US
国	國	Guó <br /><br />guó 	surname Guo<br /><br />country  / nation  / state  / national  / CL: 個｜个
英		Yīng <br /><br />yīng 	United Kingdom  / British  / England  / English  / abbr. for 英國｜英国<br /><br />hero  / outstanding  / excellent  / (literary) flower  / blossom
美		Měi <br /><br />měi 	the Americas  / abbr. for 美洲 / USA  / abbr. for 美國｜美国<br /><br />beautiful  / very satisfactory  / good  / to beautify  / to be pleased with oneself
都		Dū <br /><br />dōu <br /><br />dū 	surname Du<br /><br />all  / both  / entirely  / (used for emphasis) even  / already  / (not) at all<br /><br />capital city  / metropolis
对	對	duì 	right  / correct  / couple  / pair  / towards  / at  / for  / to face  / opposite  / to treat (sb a certain way)  / to match together  / to adjust  / to fit  / to suit  / to answer  / to reply  / classifier: couple
加拿大		Jiā ná dà 	Canada  / Canadian
加		Jiā <br /><br />jiā 	abbr. for Canada 加拿大 / surname Jia<br /><br />to add  / plus  / (used after an adverb such as 不, 大, 稍 etc, and before a disyllabic verb, to indicate that the action of the verb is applied to sth or sb previously mentioned)  / to apply (restrictions etc) to (sb)  / to give (support, consideration etc) to (sth)
拿		ná 	to hold  / to seize  / to catch  / to apprehend  / to take  / (used in the same way as 把: to mark the following noun as a direct object)
大		dà <br /><br />dài 	big  / huge  / large  / major  / great  / wide  / deep  / older (than)  / oldest  / eldest  / greatly  / very much  / (dialect) father  / father's elder or younger brother<br /><br />see 大夫
忙		máng 	busy  / hurriedly  / to hurry  / to rush
早上		zǎo shang 	early morning  / CL: 個｜个
早		zǎo 	early  / morning  / Good morning!  / long ago  / prematurely
上		shǎng <br /><br />shàng 	see 上聲｜上声<br /><br />on top  / upon  / above  / upper  / previous  / first (of multiple parts)  / to climb  / to get onto  / to go up  / to attend (class or university)
怎么样	怎麼樣	zěn me yàng 	how?  / how about?  / how was it?  / how are things?
今天		jīn tiān 	today  / at the present  / now
怎		zěn 	how
样	樣	yàng 	manner  / pattern  / way  / appearance  / shape  / classifier: kind, type
今		jīn 	today  / modern  / present  / current  / this  / now
天		tiān 	day  / sky  / heaven
家	傢	jiā <br /><br />Jiā <br /><br />jiā 	see 傢伙｜家伙<br /><br />surname Jia<br /><br />home  / family  / (polite) my (sister, uncle etc)  / classifier for families or businesses  / refers to the philosophical schools of pre-Han China  / noun suffix for a specialist in some activity, such as a musician or revolutionary, corresponding to English -ist, -er, -ary or -ian  / CL: 個｜个
北京		Běi jīng 	Beijing, capital of People's Republic of China  / Peking  / PRC government
在		zài 	(located) at  / (to be) in  / to exist  / in the middle of doing sth  / (indicating an action in progress)
北		běi 	north  / to be defeated (classical)
京		Jīng <br /><br />jīng 	abbr. for Beijing  / surname Jing  / Jing ethnic minority<br /><br />capital city of a country  / big  / algebraic term for a large number (old)  / artificial mound (old)
哪儿	哪兒	nǎr 	where?  / wherever  / anywhere
纽约	紐約	Niǔ yuē 	New York
香港		Xiāng gǎng 	Hong Kong
儿	兒	ér <br /><br />r 	child  / son<br /><br />non-syllabic diminutive suffix  / retroflex final
纽	紐	niǔ 	to turn  / to wrench  / button  / nu (Greek letter Νν)
约	約	yāo <br /><br />yuē 	to weigh in a balance or on a scale<br /><br />to make an appointment  / to invite  / approximately  / pact  / treaty  / to economize  / to restrict  / to reduce (a fraction)  / concise
香		xiāng 	fragrant  / sweet smelling  / aromatic  / savory or appetizing  / (to eat) with relish  / (of sleep) sound  / perfume or spice  / joss or incense stick  / CL: 根
港		Gǎng <br /><br />gǎng 	Hong Kong, abbr. for 香港 / surname Gang<br /><br />harbor  / port  / CL: 個｜个
住		zhù 	to live  / to dwell  / to stay  / to reside  / to stop  / (suffix indicating firmness, steadiness, or coming to a halt)
伦敦	倫敦	Lún dūn 	London, capital of United Kingdom
台湾	臺灣	Tái wān 	Taiwan
伦	倫	lún 	human relationship  / order  / coherence
敦		dūn 	kindhearted  / place name
台		Tái <br /><br />tái <br /><br />tái <br /><br />Tái <br /><br />tái <br /><br />tái 	Taiwan (abbr.)  / surname Tai<br /><br />(classical) you (in letters)  / variant of 臺｜台<br /><br />desk  / table  / counter<br /><br />Taiwan (abbr.)<br /><br />platform  / stage  / terrace  / stand  / support  / station  / broadcasting station  / classifier for vehicles or machines<br /><br />typhoon
湾	灣	wān 	bay  / gulf  / to cast anchor  / to moor (a boat)
谢谢	謝謝	xiè xie 	to thank  / thanks  / thank you
不客气	不客氣	bù kè qi 	you're welcome  / don't mention it  / impolite  / rude  / blunt
谢	謝	Xiè <br /><br />xiè 	surname Xie<br /><br />to thank  / to apologize  / to wither (of flowers, leaves etc)  / to decline
客		kè 	customer  / visitor  / guest
气	氣	qì 	gas  / air  / smell  / weather  / to make angry  / to annoy  / to get angry  / vital energy  / qi
对不起	對不起	duì bu qǐ 	unworthy  / to let down  / I'm sorry  / excuse me  / pardon me  / if you please  / sorry? (please repeat)
没关系	沒關係	méi guān xi 	it doesn't matter
起		qǐ 	to rise  / to raise  / to get up  / to set out  / to start  / to appear  / to launch  / to initiate (action)  / to draft  / to establish  / to get (from a depot or counter)  / verb suffix, to start  / starting from (a time, place, price etc)  / classifier for occurrences or unpredictable events: case, instance  / classifier for groups: batch, group
没	沒	méi <br /><br />mò 	(negative prefix for verbs)  / have not  / not<br /><br />drowned  / to end  / to die  / to inundate
关	關	Guān <br /><br />guān 	surname Guan<br /><br />mountain pass  / to close  / to shut  / to turn off  / to concern  / to involve
系	係	xì <br /><br />xì <br /><br />jì <br /><br />xì 	to connect  / to relate to  / to tie up  / to bind  / to be (literary)<br /><br />system  / department  / faculty<br /><br />to tie  / to fasten  / to button up<br /><br />to connect  / to arrest  / to worry
爸爸		bà ba 	(informal) father  / CL: 個｜个, 位
妈妈	媽媽	mā ma 	mama  / mommy  / mother  / CL: 個｜个, 位
爱	愛	ài 	to love  / to be fond of  / to like  / affection  / to be inclined (to do sth)  / to tend to (happen)
家人		jiā rén 	household  / (one's) family
爸		bà 	father  / dad  / pa  / papa
妈	媽	mā 	ma  / mom  / mother
谁	誰	shéi 	who  / also pr. [shui2]
那		Nā <br /><br />Nuó <br /><br />nà <br /><br />nuó 	surname Na<br /><br />surname Nuo<br /><br />that  / those  / then (in that case)  / commonly pr. [nei4] before a classifier, esp. in Beijing<br /><br />(archaic) many  / beautiful  / how  / old variant of 挪
个	個	gè 	individual  / this  / that  / size  / classifier for people or objects in general
这	這	zhè 	this  / these  / (commonly pr. [zhei4] before a classifier, esp. in Beijing)
哥哥		gē ge 	older brother  / CL: 個｜个, 位
姐姐		jiě jie 	older sister  / CL: 個｜个
有		yǒu 	to have  / there is  / there are  / to exist  / to be
哥		gē 	elder brother
姐		jiě 	older sister
弟弟		dì di 	younger brother  / CL: 個｜个, 位
和		Hé <br /><br />hé <br /><br />hè <br /><br />hú <br /><br />huó <br /><br />huò 	surname He  / Japanese (food, clothes etc)<br /><br />and  / together with  / with  / sum  / union  / peace  / harmony  / Taiwan pr. [han4] when it means "and" or "with"<br /><br />to compose a poem in reply (to sb's poem) using the same rhyme sequence  / to join in the singing  / to chime in with others<br /><br />to complete a set in mahjong or playing cards<br /><br />to combine a powdery substance (flour, plaster etc) with water  / Taiwan pr. [huo4]<br /><br />to mix (ingredients) together  / to blend  / classifier for rinses of clothes  / classifier for boilings of medicinal herbs
妹妹		mèi mei 	younger sister  / young woman  / CL: 個｜个
没	沒	méi <br /><br />mò 	(negative prefix for verbs)  / have not  / not<br /><br />drowned  / to end  / to die  / to inundate
弟		dì 	younger brother  / junior male  / I (modest word in letter)
妹		mèi 	younger sister
请问	請問	qǐng wèn 	Excuse me, may I ask...?
知道		zhī dào 	to know  / to become aware of  / also pr. [zhi1 dao5]
问	問	wèn 	to ask
请	請	qǐng 	to ask  / to invite  / please (do sth)  / to treat (to a meal etc)  / to request
知		zhī 	to know  / to be aware
道		dào 	road  / path  / CL: 條｜条, 股 / principle  / truth  / morality  / reason  / skill  / method  / Dao (of Daoism)  / to say  / to speak  / to talk  / classifier for long thin things (rivers, cracks etc), barriers (walls, doors etc), questions (in an exam etc), commands, courses in a meal, steps in a process  / (old) administrative division (similar to province in Tang times)
说	說	shuì <br /><br />shuō 	to persuade<br /><br />to speak  / to say  / to explain  / to scold  / to tell off  / a theory (typically the last character in a compound, as in 日心說｜日心说 heliocentric theory)
英语	英語	Yīng yǔ 	English (language)
汉语	漢語	Hàn yǔ 	Chinese language  / CL: 門｜门
汉	漢	Hàn <br /><br />hàn 	Han ethnic group  / Chinese (language)  / the Han dynasty (206 BC-220 AD)<br /><br />man
语	語	yǔ <br /><br />yù 	dialect  / language  / speech<br /><br />to tell to
帮助	幫助	bāng zhù 	assistance  / aid  / to help  / to assist
再		zài 	again  / once more  / re-  / second  / another  / then (after sth, and not until then)
请	請	qǐng 	to ask  / to invite  / please (do sth)  / to treat (to a meal etc)  / to request
次		cì 	next in sequence  / second  / the second (day, time etc)  / secondary  / vice-  / sub-  / infra-  / inferior quality  / substandard  / order  / sequence  / hypo- (chemistry)  / classifier for enumerated events: time
帮	幫	bāng 	to help  / to assist  / to support  / for sb (i.e. as a help)  / hired (as worker)  / side (of pail, boat etc)  / outer layer  / upper (of a shoe)  / group  / gang  / clique  / party  / secret society
助		zhù 	to help  / to assist
早安		zǎo ān 	Good morning!
晚安		wǎn ān 	Good night!  / Good evening!
一会儿	一會兒	yī huìr 	a moment  / a while  / in a moment  / now...now...  / also pr. [yi1 hui3 r5]
见	見	jiàn <br /><br />xiàn 	to see  / to meet  / to appear (to be sth)  / to interview<br /><br />to appear  / also written 現｜现
会	會	huì <br /><br />kuài 	can  / to be possible  / to be able to  / will  / to be likely to  / to be sure to  / to assemble  / to meet  / to gather  / to see  / union  / group  / association  / CL: 個｜个 / a moment (Taiwan pr. for this sense is [hui3])<br /><br />to balance an account  / accountancy  / accounting
安		Ān <br /><br />ān 	surname An<br /><br />content  / calm  / still  / quiet  / safe  / secure  / in good health  / to find a place for  / to install  / to fix  / to fit  / to bring (a charge against sb)  / to pacify  / to harbor (good intentions)  / security  / safety  / peace  / ampere
最近		zuì jìn 	recent  / recently  / these days  / latest  / soon  / nearest (of locations)  / shortest (of routes)
好久不见	好久不見	hǎo jiǔ bu jiàn 	long time no see
不错	不錯	bù cuò 	correct  / right  / not bad  / pretty good
最		zuì 	most  / the most  / -est (superlative suffix)
近		jìn 	near  / close to  / approximately
久		jiǔ 	(long) time  / (long) duration of time
错	錯	Cuò <br /><br />cuò 	surname Cuo<br /><br />mistake  / wrong  / bad  / interlocking  / complex  / to grind  / to polish  / to alternate  / to stagger  / to miss  / to let slip  / to evade  / to inlay with gold or silver
要		yāo <br /><br />yào 	to demand  / to request  / to coerce<br /><br />important  / vital  / to want  / to ask for  / will  / going to (as future auxiliary)  / may  / must  / (used in a comparison) must be  / probably  / if
热	熱	rè 	to warm up  / to heat up  / hot (of weather)  / heat  / fervent
冰		bīng 	ice  / CL: 塊｜块 / to chill sth  / (of an object or substance) to feel cold  / (of a person) cold  / unfriendly  / (slang) methamphetamine
牛奶		niú nǎi 	cow's milk  / CL: 瓶, 杯
咖啡		kā fēi 	coffee (loanword)  / CL: 杯
牛		Niú <br /><br />niú 	surname Niu<br /><br />ox  / cow  / bull  / CL: 條｜条, 頭｜头 / (slang) awesome
奶		nǎi <br /><br />nǎi 	breast  / milk  / to breastfeed<br /><br />mother  / variant of 奶
咖		kā 	coffee  / class  / grade
啡		fēi 	(phonetic component)
洗手间	洗手間	xǐ shǒu jiān 	toilet  / lavatory  / washroom
医院	醫院	yī yuàn 	hospital  / CL: 所, 家, 座
洗		xǐ 	to wash  / to bathe  / to develop (photo)
手		shǒu 	hand  / (formal) to hold  / person engaged in certain types of work  / person skilled in certain types of work  / personal(ly)  / convenient  / classifier for skill  / CL: 雙｜双, 隻｜只
间	間	jiān <br /><br />jiàn 	between  / among  / within a definite time or space  / room  / section of a room or lateral space between two pairs of pillars  / classifier for rooms<br /><br />gap  / to separate  / to thin out (seedlings)  / to sow discontent
院		yuàn 	courtyard  / institution  / CL: 個｜个
这儿	這兒	zhèr 	here
那儿	那兒	nàr 	there
饭馆	飯館	fàn guǎn 	restaurant  / CL: 家
馆	館	guǎn 	building  / shop  / term for certain service establishments  / embassy or consulate  / schoolroom (old)  / CL: 家
年		Nián <br /><br />nián <br /><br />nián 	surname Nian<br /><br />year  / CL: 個｜个<br /><br />grain  / harvest (old)  / variant of 年
月		yuè 	moon  / month  / monthly  / CL: 個｜个, 輪｜轮
号	號	háo <br /><br />hào 	roar  / cry  / CL: 個｜个<br /><br />ordinal number  / day of a month  / mark  / sign  / business establishment  / size  / ship suffix  / horn (wind instrument)  / bugle call  / assumed name  / to take a pulse  / classifier used to indicate number of people
几		jī <br /><br />jī <br /><br />jǐ 	small table<br /><br />almost<br /><br />how much  / how many  / several  / a few
〇		líng 	zero
星期		xīng qī 	week  / CL: 個｜个 / day of the week  / Sunday
明天		míng tiān 	tomorrow
天		tiān 	day  / sky  / heaven
日		Rì <br /><br />rì 	abbr. for 日本, Japan<br /><br />sun  / day  / date, day of the month
星		xīng 	star  / heavenly body  / satellite  / small amount
期		qī 	a period of time  / phase  / stage  / classifier for issues of a periodical, courses of study  / time  / term  / period  / to hope  / Taiwan pr. [qi2]
明		Míng <br /><br />míng 	Ming Dynasty (1368-1644)  / surname Ming  / Ming (c. 2000 BC), fourth of the legendary Flame Emperors, 炎帝 descended from Shennong 神農｜神农 Farmer God<br /><br />bright  / opposite: dark 暗 / (of meaning) clear  / to understand  / next  / public or open  / wise  / generic term for a sacrifice to the gods
点	點	diǎn 	point  / dot  / drop  / speck  / o'clock  / point (in space or time)  / to draw a dot  / to check on a list  / to choose  / to order (food in a restaurant)  / to touch briefly  / to hint  / to light  / to ignite  / to pour a liquid drop by drop  / (old) one fifth of a two-hour watch 更 / dot stroke in Chinese characters  / classifier for items
现在	現在	xiàn zài 	now  / at present  / at the moment  / modern  / current  / nowadays
半		bàn 	half  / semi-  / incomplete  / (after a number) and a half
现	現	xiàn 	to appear  / present  / now  / existing  / current
孩子		hái zi 	child
两	兩	liǎng 	two  / both  / some  / a few  / tael, unit of weight equal to 50 grams (modern) or 1⁄16 of a catty 斤 (old)
孩		hái 	child
子		zǐ <br /><br />zi 	son  / child  / seed  / egg  / small thing  / 1st earthly branch: 11 p.m.-1 a.m., midnight, 11th solar month (7th December to 5th January), year of the Rat  / Viscount, fourth of five orders of nobility 五等爵位 / ancient Chinese compass point: 0° (north)<br /><br />(noun suffix)
女儿	女兒	nǚ ér 	daughter
儿子	兒子	ér zi 	son
岁	歲	suì 	classifier for years (of age)  / year  / year (of crop harvests)
女		nǚ 	female  / woman  / daughter
儿	兒	ér <br /><br />r 	child  / son<br /><br />non-syllabic diminutive suffix  / retroflex final
妻子		qī zǐ <br /><br />qī zi 	wife and children<br /><br />wife  / CL: 個｜个
丈夫		zhàng fu 	husband  / CL: 個｜个
妻		qī <br /><br />qì 	wife<br /><br />to marry off (a daughter)
丈		zhàng 	measure of length, ten Chinese feet (3.3 m)  / to measure  / husband  / polite appellation for an older male
夫		fū <br /><br />fú 	husband  / man  / manual worker  / conscripted laborer (old)<br /><br />(classical) this, that  / he, she, they  / (exclamatory final particle)  / (initial particle, introduces an opinion)
猫	貓	māo 	cat  / CL: 隻｜只 / (dialect) to hide oneself  / (coll.) modem
它		tā 	it
狗		gǒu 	dog  / CL: 隻｜只, 條｜条
喂		wéi <br /><br />wèi <br /><br />wèi 	hello (when answering the phone)<br /><br />hey  / to feed (an animal, baby, invalid etc)<br /><br />to feed
慢		màn 	slow
一点儿		yī diǎnr 	erhua variant of 一點｜一点 
快		kuài 	rapid  / quick  / speed  / rate  / soon  / almost  / to make haste  / clever  / sharp (of knives or wits)  / forthright  / plainspoken  / gratified  / pleased  / pleasant
得		dé <br /><br />de <br /><br />děi 	to obtain  / to get  / to gain  / to catch (a disease)  / proper  / suitable  / proud  / contented  / to allow  / to permit  / ready  / finished<br /><br />structural particle: used after a verb (or adjective as main verb), linking it to following phrase indicating effect, degree, possibility etc<br /><br />to have to  / must  / ought to  / to need to
明白		míng bai 	clear  / obvious  / unequivocal  / to understand  / to realize
白		Bái <br /><br />bái 	surname Bai<br /><br />white  / snowy  / pure  / bright  / empty  / blank  / plain  / clear  / to make clear  / in vain  / gratuitous  / free of charge  / reactionary  / anti-communist  / funeral  / to stare coldly  / to write wrong character  / to state  / to explain  / vernacular  / spoken lines in opera
漂亮		piào liang 	pretty  / beautiful
高		Gāo <br /><br />gāo 	surname Gao<br /><br />high  / tall  / above average  / loud  / your (honorific)
漂		piāo <br /><br />piǎo <br /><br />piào 	to float  / to drift<br /><br />to bleach<br /><br />elegant  / polished
亮		liàng 	bright  / clear  / resonant  / to shine  / to show  / to reveal
朋友		péng you 	friend  / CL: 個｜个, 位
男		nán 	male  / Baron, lowest of five orders of nobility 五等爵位 / CL: 個｜个
矮		ǎi 	low  / short (in length)
朋		péng 	friend
友		yǒu 	friend
女		nǚ 	female  / woman  / daughter
可爱	可愛	kě ài 	adorable  / cute  / lovely
非常		fēi cháng 	very  / very much  / unusual  / extraordinary
可		kě <br /><br />kè 	can  / may  / able to  / to approve  / to permit  / to suit  / (particle used for emphasis) certainly  / very<br /><br />see 可汗
非		Fēi <br /><br />fēi 	abbr. for 非洲, Africa<br /><br />to not be  / not  / wrong  / incorrect  / non-  / un-  / in-  / to reproach or blame  / (colloquial) to insist on  / simply must
常		Cháng <br /><br />cháng 	surname Chang<br /><br />always  / ever  / often  / frequently  / common  / general  / constant
上午		shàng wǔ 	morning  / CL: 個｜个
分		fēn <br /><br />fèn 	to divide  / to separate  / to distribute  / to allocate  / to distinguish (good and bad)  / part or subdivision  / fraction  / one tenth (of certain units)  / unit of length equivalent to 0.33 cm  / minute (unit of time)  / minute (angular measurement unit)  / a point (in sports or games)  / 0.01 yuan (unit of money)<br /><br />part  / share  / ingredient  / component
下午		xià wǔ 	afternoon  / CL: 個｜个 / p.m.
晚上		wǎn shang 	evening  / night  / CL: 個｜个 / in the evening
午		wǔ 	7th earthly branch: 11 a.m.-1 p.m., noon, 5th solar month (6th June-6th July), year of the Horse  / ancient Chinese compass point: 180° (south)
晚		wǎn 	evening  / night  / late
下		xià 	down  / downwards  / below  / lower  / later  / next (week etc)  / second (of two parts)  / to decline  / to go down  / to arrive at (a decision, conclusion etc)  / measure word to show the frequency of an action
每		měi 	each  / every
中午		zhōng wǔ 	noon  / midday  / CL: 個｜个
周末	週末	zhōu mò 	weekend
天		tiān 	day  / sky  / heaven
周		Zhōu <br /><br />zhōu <br /><br />zhōu 	surname Zhou  / Zhou Dynasty (1046-256 BC)<br /><br />to make a circuit  / to circle  / circle  / circumference  / lap  / cycle  / complete  / all  / all over  / thorough  / to help financially<br /><br />week  / weekly  / variant of 周
末		mò 	tip  / end  / final stage  / latter part  / inessential detail  / powder  / dust  / opera role of old man
昨天		zuó tiān 	yesterday
上		shǎng <br /><br />shàng 	see 上聲｜上声<br /><br />on top  / upon  / above  / upper  / previous  / first (of multiple parts)  / to climb  / to get onto  / to go up  / to attend (class or university)
了		le <br /><br />liǎo <br /><br />liǎo 	(modal particle intensifying preceding clause)  / (completed action marker)<br /><br />to finish  / to achieve  / variant of 瞭｜了 / to understand clearly<br /><br />(of eyes) bright  / clear-sighted  / to understand clearly
做		zuò 	to do  / to make  / to produce  / to write  / to compose  / to act as  / to engage in  / to hold (a party)  / to be  / to become  / to function (in some capacity)  / to serve as  / to be used for  / to form (a bond or relationship)  / to pretend  / to feign  / to act a part  / to put on appearance
昨		zuó 	yesterday
今年		jīn nián 	this year
去年		qù nián 	last year
明年		míng nián 	next year
下		xià 	down  / downwards  / below  / lower  / later  / next (week etc)  / second (of two parts)  / to decline  / to go down  / to arrive at (a decision, conclusion etc)  / measure word to show the frequency of an action
会	會	huì <br /><br />kuài 	can  / to be possible  / to be able to  / will  / to be likely to  / to be sure to  / to assemble  / to meet  / to gather  / to see  / union  / group  / association  / CL: 個｜个 / a moment (Taiwan pr. for this sense is [hui3])<br /><br />to balance an account  / accountancy  / accounting
去		qù 	to go  / to go to (a place)  / (of a time etc) last  / just passed  / to send  / to remove  / to get rid of  / to reduce  / to be apart from in space or time  / to die (euphemism)  / to play (a part)  / (when used either before or after a verb) to go in order to do sth  / (after a verb of motion indicates movement away from the speaker)  / (used after certain verbs to indicate detachment or separation)
旁边	旁邊	páng biān 	lateral  / side  / to the side  / beside
左边	左邊	zuǒ bian 	left  / the left side  / to the left of
右边	右邊	yòu bian 	right side  / right, to the right
旁		páng 	beside  / one side  / other  / side  / self  / the right-hand side of split Chinese character, often the phonetic
左		Zuǒ <br /><br />zuǒ 	surname Zuo<br /><br />left  / the Left (politics)  / east  / unorthodox  / queer  / wrong  / differing  / opposite  / variant of 佐
右		yòu 	right (-hand)  / the Right (politics)  / west (old)
边	邊	biān <br /><br />bian 	side  / edge  / margin  / border  / boundary  / CL: 個｜个 / simultaneously<br /><br />suffix of a noun of locality
前面		qián miàn 	ahead  / in front  / preceding  / above  / also pr. [qian2 mian5]
后面	後面	hòu miàn 	rear  / back  / behind  / later  / afterwards  / also pr. [hou4 mian5]
学校	學校	xué xiào 	school  / CL: 所
前		qián 	front  / forward  / ahead  / first  / top (followed by a number)  / future  / ago  / before  / BC (e.g. 前293年)  / former  / formerly
后		Hòu <br /><br />hòu <br /><br />hòu 	surname Hou<br /><br />empress  / queen<br /><br />back  / behind  / rear  / afterwards  / after  / later
校		jiào <br /><br />xiào 	to proofread  / to check  / to compare<br /><br />school  / military officer  / CL: 所
走		zǒu 	to walk  / to go  / to run  / to move (of vehicle)  / to visit  / to leave  / to go away  / to die (euph.)  / from  / through  / away (in compound verbs, such as 撤走)  / to change (shape, form, meaning)
到		dào 	to (a place)  / until (a time)  / up to  / to go  / to arrive  / (verb complement denoting completion or result of an action)
路		Lù <br /><br />lù 	surname Lu<br /><br />road  / CL: 條｜条 / journey  / route  / line (bus etc)  / sort  / kind
怎么	怎麼	zěn me 	how?  / what?  / why?
哪里	哪裏	nǎ lǐ <br /><br />nǎ lǐ 	where?  / somewhere  / anywhere  / wherever  / nowhere (negative answer to question)  / humble expression denying compliment  / also written 哪裡｜哪里<br /><br />where?  / somewhere  / anywhere  / wherever  / nowhere (negative answer to question)  / humble expression denying compliment
这里	這裡	zhè lǐ 	here
那里	那裏	nà li <br /><br />nà li 	there  / that place  / also written 那裡｜那里<br /><br />there  / that place
往		wǎng 	to go (in a direction)  / to  / towards  / (of a train) bound for  / past  / previous
里	裡	lǐ <br /><br />Lǐ <br /><br />lǐ 	lining  / interior  / inside  / internal  / also written 裏｜里<br /><br />Li (surname)<br /><br />li, ancient measure of length, approx. 500 m  / neighborhood  / ancient administrative unit of 25 families  / (Tw) borough, administrative unit between the township 鎮｜镇 and neighborhood 鄰｜邻 levels
喜欢	喜歡	xǐ huan 	to like  / to be fond of
看		kān <br /><br />kàn 	to look after  / to take care of  / to watch  / to guard<br /><br />to see  / to look at  / to read  / to watch  / to visit  / to call on  / to consider  / to regard as  / to look after  / to treat (an illness)  / to depend on  / to feel (that)  / (after verb) to give it a try  / Watch out! (for a danger)
书	書	Shū <br /><br />shū 	abbr. for 書經｜书经<br /><br />book  / letter  / document  / CL: 本, 冊｜册, 部 / to write
在		zài 	(located) at  / (to be) in  / to exist  / in the middle of doing sth  / (indicating an action in progress)
喜		xǐ 	to be fond of  / to like  / to enjoy  / to be happy  / to feel pleased  / happiness  / delight  / glad
欢	歡	huān <br /><br />huān <br /><br />huān 	joyous  / happy  / pleased<br /><br />hubbub  / clamor  / variant of 歡｜欢<br /><br />a breed of horse  / variant of 歡｜欢
玩		wán 	to play  / to have fun  / to trifle with  / toy  / sth used for amusement  / curio or antique (Taiwan pr. [wan4])  / to keep sth for entertainment
电脑	電腦	diàn nǎo 	computer  / CL: 臺｜台
游戏	遊戲	yóu xì 	game  / CL: 場｜场 / to play
最		zuì 	most  / the most  / -est (superlative suffix)
脑	腦	nǎo 	brain  / mind  / head  / essence
游		Yóu <br /><br />yóu <br /><br />yóu 	surname You<br /><br />to swim  / variant of 遊｜游<br /><br />to walk  / to tour  / to roam  / to travel
戏	戲	xì 	trick  / drama  / play  / show  / CL: 出, 場｜场, 臺｜台
听		yǐn <br /><br />tīng <br /><br />tìng 	smile (archaic)<br /><br />to listen  / to hear  / to obey  / a can (loanword from English "tin")  / classifier for canned beverages<br /><br />(literary pronunciation, still advocated in Taiwan) to rule  / to sentence  / to allow
音乐	音樂	yīn yuè 	music  / CL: 張｜张, 曲, 段
歌		gē 	song  / CL: 支, 首 / to sing
音		yīn 	sound  / noise  / note (of musical scale)  / tone  / news  / syllable  / reading (phonetic value of a character)
乐	樂	Lè <br /><br />Yuè <br /><br />lè <br /><br />yuè 	surname Le<br /><br />surname Yue<br /><br />happy  / cheerful  / to laugh<br /><br />music
跳舞		tiào wǔ 	to dance
会	會	huì <br /><br />kuài 	can  / to be possible  / to be able to  / will  / to be likely to  / to be sure to  / to assemble  / to meet  / to gather  / to see  / union  / group  / association  / CL: 個｜个 / a moment (Taiwan pr. for this sense is [hui3])<br /><br />to balance an account  / accountancy  / accounting
唱		chàng 	to sing  / to call loudly  / to chant
跳		tiào 	to jump  / to hop  / to skip over  / to bounce  / to palpitate
舞		wǔ 	to dance  / to wield  / to brandish
起床		qǐ chuáng 	to get out of bed  / to get up
上学	上學	shàng xué 	to go to school  / to attend school
上班		shàng bān 	to go to work  / to be on duty  / to start work  / to go to the office
早饭	早飯	zǎo fàn 	breakfast  / CL: 份, 頓｜顿, 次, 餐
做		zuò 	to do  / to make  / to produce  / to write  / to compose  / to act as  / to engage in  / to hold (a party)  / to be  / to become  / to function (in some capacity)  / to serve as  / to be used for  / to form (a bond or relationship)  / to pretend  / to feign  / to act a part  / to put on appearance
起		qǐ 	to rise  / to raise  / to get up  / to set out  / to start  / to appear  / to launch  / to initiate (action)  / to draft  / to establish  / to get (from a depot or counter)  / verb suffix, to start  / starting from (a time, place, price etc)  / classifier for occurrences or unpredictable events: case, instance  / classifier for groups: batch, group
床		chuáng 	bed  / couch  / classifier for beds  / CL: 張｜张
班		Bān <br /><br />bān 	surname Ban<br /><br />team  / class  / squad  / work shift  / ranking  / CL: 個｜个 / classifier for groups
从	從	Cóng <br /><br />cóng <br /><br />zòng 	surname Cong<br /><br />from  / through  / via  / to follow  / to obey  / to engage in (an activity)  / never (in negative sentence)  / (Taiwan pr. [zong4]) retainer  / assistant  / accomplice  / related by common paternal grandfather or earlier ancestor<br /><br />second cousin
睡觉	睡覺	shuì jiào 	to go to bed  / to sleep
午饭	午飯	wǔ fàn 	lunch  / CL: 份, 頓｜顿, 次, 餐
睡		shuì 	to sleep  / to lie down
觉	覺	jiào <br /><br />jué 	a nap  / a sleep  / CL: 場｜场<br /><br />to feel  / to find that  / thinking  / awake  / aware
放学	放學	fàng xué 	to dismiss students at the end of the school day
下班		xià bān 	to finish work  / to get off work
回		huí <br /><br />huí 	to circle  / to go back  / to turn around  / to answer  / to return  / to revolve  / Hui ethnic group (Chinese Muslims)  / time  / classifier for acts of a play  / section or chapter (of a classic book)<br /><br />to curve  / to return  / to revolve
晚饭	晚飯	wǎn fàn 	evening meal  / dinner  / supper  / CL: 份, 頓｜顿, 次, 餐
放		fàng 	to put  / to place  / to release  / to free  / to let go  / to let out  / to set off (fireworks)
钱	錢	Qián <br /><br />qián 	surname Qian<br /><br />coin  / money  / CL: 筆｜笔 / unit of weight, one tenth of a tael 兩｜两
块	塊	kuài 	lump (of earth)  / chunk  / piece  / classifier for pieces of cloth, cake, soap etc  / (coll.) classifier for money and currency units
只		zhǐ <br /><br />zhǐ <br /><br />zhī 	only  / merely  / just  / but<br /><br />grain that has begun to ripen  / variant of 衹｜只<br /><br />classifier for birds and certain animals, one of a pair, some utensils, vessels etc
买	買	mǎi 	to buy  / to purchase
一共		yī gòng 	altogether
毛		Máo <br /><br />máo 	surname Mao<br /><br />hair  / feather  / down  / wool  / mildew  / mold  / coarse or semifinished  / young  / raw  / careless  / unthinking  / nervous  / scared  / (of currency) to devalue or depreciate  / classifier for Chinese fractional monetary unit ( = 角 , = one-tenth of a yuan or 10 fen 分)
分		fēn <br /><br />fèn 	to divide  / to separate  / to distribute  / to allocate  / to distinguish (good and bad)  / part or subdivision  / fraction  / one tenth (of certain units)  / unit of length equivalent to 0.33 cm  / minute (unit of time)  / minute (angular measurement unit)  / a point (in sports or games)  / 0.01 yuan (unit of money)<br /><br />part  / share  / ingredient  / component
共		gòng 	common  / general  / to share  / together  / total  / altogether  / abbr. for 共產黨｜共产党, Communist party
信用卡		xìn yòng kǎ 	credit card
收		shōu 	to receive  / to accept  / to collect  / to put away  / to restrain  / to stop  / in care of (used on address line after name)
千		qiān <br /><br />qiān 	thousand<br /><br />see 鞦韆｜秋千
信		xìn 	letter  / mail  / CL: 封 / to trust  / to believe  / to profess faith in  / truthful  / confidence  / trust  / at will  / at random
用		yòng 	to use  / to employ  / to have to  / to eat or drink  / expense or outlay  / usefulness  / hence  / therefore
卡		kǎ <br /><br />qiǎ 	to stop  / to block  / card  / CL: 張｜张, 片 / calorie  / cassette  / (computing) (coll.) slow<br /><br />to block  / to be stuck  / to be wedged  / customs station  / a clip  / a fastener  / a checkpost  / Taiwan pr. [ka3]
贵	貴	guì 	expensive  / noble  / precious  / (honorific) your
便宜		biàn yí <br /><br />pián yi 	convenient<br /><br />cheap  / inexpensive  / small advantages  / to let sb off lightly
现金	現金	xiàn jīn 	cash
便		biàn <br /><br />pián 	plain  / informal  / suitable  / convenient  / opportune  / to urinate or defecate  / equivalent to 就: then  / in that case  / even if  / soon afterwards<br /><br />see 便宜
宜		Yí <br /><br />yí 	surname Yi<br /><br />proper  / should  / suitable  / appropriate
金		Jīn <br /><br />jīn 	surname Jin  / surname Kim (Korean)  / Jurchen Jin dynasty (1115-1234)<br /><br />gold  / chemical element Au  / generic term for lustrous and ductile metals  / money  / golden  / highly respected  / one of the eight ancient musical instruments 八音
太		tài 	highest  / greatest  / too (much)  / very  / extremely
万		Mò <br /><br />Wàn <br /><br />wàn 	see 万俟<br /><br />surname Wan<br /><br />ten thousand  / a great number
行		háng <br /><br />xíng 	row  / line  / commercial firm  / line of business  / profession  / to rank (first, second etc) among one's siblings (by age)  / (in data tables) row  / (Tw) column<br /><br />to walk  / to go  / to travel  / a visit  / temporary  / makeshift  / current  / in circulation  / to do  / to perform  / capable  / competent  / effective  / all right  / OK!  / will do  / behavior  / conduct  / Taiwan pr. [xing4] for the behavior-conduct sense
了		le <br /><br />liǎo <br /><br />liǎo 	(modal particle intensifying preceding clause)  / (completed action marker)<br /><br />to finish  / to achieve  / variant of 瞭｜了 / to understand clearly<br /><br />(of eyes) bright  / clear-sighted  / to understand clearly
想		xiǎng 	to think  / to believe  / to suppose  / to wish  / to want  / to miss (feel wistful about the absence of sb or sth)
干	乾	Gān <br /><br />gān <br /><br />gān <br /><br />gàn 	surname Gan<br /><br />dry  / clean  / in vain  / dried food  / foster  / adoptive  / to ignore<br /><br />to concern  / to interfere  / shield  / stem<br /><br />tree trunk  / main part of sth  / to manage  / to work  / to do  / capable  / cadre  / to kill (slang)  / to fuck (vulgar)
影		yǐng 	picture  / image  / film  / movie  / photograph  / reflection  / shadow  / trace
视	視	shì 	to look at  / to regard  / to inspect
电视	電視	diàn shì 	television  / TV  / CL: 臺｜台, 個｜个
电影	電影	diàn yǐng 	movie  / film  / CL: 部, 片, 幕, 場｜场
报纸	報紙	bào zhǐ 	newspaper  / newsprint  / CL: 份, 期, 張｜张
上网	上網	shàng wǎng 	to go online  / to connect to the Internet  / (of a document etc) to be uploaded to the Internet  / (tennis, volleyball etc) to move in close to the net
报	報	bào 	to announce  / to inform  / report  / newspaper  / recompense  / revenge  / CL: 份, 張｜张
纸	紙	zhǐ 	paper  / CL: 張｜张, 沓 / classifier for documents, letter etc
网	網	wǎng 	net  / network
手机	手機	shǒu jī 	cell phone  / mobile phone  / CL: 部, 支
用		yòng 	to use  / to employ  / to have to  / to eat or drink  / expense or outlay  / usefulness  / hence  / therefore
新闻	新聞	xīn wén 	news  / CL: 條｜条, 個｜个
机	機	Jī <br /><br />jī 	surname Ji<br /><br />machine  / engine  / opportunity  / intention  / aircraft  / pivot  / crucial point  / flexible (quick-witted)  / organic  / CL: 臺｜台
新		Xīn <br /><br />xīn 	abbr. for Xinjiang 新疆 or Singapore 新加坡 / surname Xin<br /><br />new  / newly  / meso- (chemistry)
闻	聞	Wén <br /><br />wén 	surname Wen<br /><br />to hear  / news  / well-known  / famous  / reputation  / fame  / to smell  / to sniff at
明星		míng xīng 	star  / celebrity
体育	體育	tǐ yù 	sports  / physical education
节目	節目	jié mù 	program  / item (on a program)  / CL: 臺｜台, 個｜个, 套
韩国	韓國	Hán guó 	South Korea (Republic of Korea)  / Han, one of the Seven Hero States of the Warring States 戰國七雄｜战国七雄 / Korea from the fall of the Joseon dynasty in 1897
体	體	tǐ 	body  / form  / style  / system  / substance  / to experience  / aspect (linguistics)
节	節	jiē <br /><br />jié 	see 節骨眼｜节骨眼<br /><br />festival  / holiday  / node  / joint  / section  / segment  / part  / to economize  / to save  / to abridge  / moral integrity  / classifier for segments, e.g. lessons, train wagons, biblical verses  / CL: 個｜个
韩	韓	Hán 	Han, one of the Seven Hero States of the Warring States 戰國七雄｜战国七雄 / Korea from the fall of the Joseon dynasty in 1897  / Korea, esp. South Korea 大韓民國｜大韩民国 / surname Han
育		yù 	to have children  / to raise or bring up  / to educate
目		mù 	eye  / item  / section  / list  / catalogue  / table of contents  / order (taxonomy)  / goal  / name  / title
桌		zhuō 	table  / desk  / classifier for tables of guests at a banquet etc
找		zhǎo 	to try to find  / to look for  / to call on sb  / to find  / to seek  / to return  / to give change
桌子		zhuō zi 	table  / desk  / CL: 張｜张, 套
上		shǎng <br /><br />shàng 	see 上聲｜上声<br /><br />on top  / upon  / above  / upper  / previous  / first (of multiple parts)  / to climb  / to get onto  / to go up  / to attend (class or university)
椅子		yǐ zi 	chair  / CL: 把, 套
下		xià 	down  / downwards  / below  / lower  / later  / next (week etc)  / second (of two parts)  / to decline  / to go down  / to arrive at (a decision, conclusion etc)  / measure word to show the frequency of an action
见	見	jiàn <br /><br />xiàn 	to see  / to meet  / to appear (to be sth)  / to interview<br /><br />to appear  / also written 現｜现
椅		yǐ 	chair
房间	房間	fáng jiān 	room  / CL: 間｜间, 個｜个
冰箱		bīng xiāng 	icebox  / freezer cabinet  / refrigerator  / CL: 臺｜台, 個｜个
里	裡	lǐ <br /><br />Lǐ <br /><br />lǐ 	lining  / interior  / inside  / internal  / also written 裏｜里<br /><br />Li (surname)<br /><br />li, ancient measure of length, approx. 500 m  / neighborhood  / ancient administrative unit of 25 families  / (Tw) borough, administrative unit between the township 鎮｜镇 and neighborhood 鄰｜邻 levels
外		wài 	outside  / in addition  / foreign  / external
房		Fáng <br /><br />fáng 	surname Fang<br /><br />house  / room  / CL: 間｜间 / branch of an extended family  / classifier for family members (or concubines)
间	間	jiān <br /><br />jiàn 	between  / among  / within a definite time or space  / room  / section of a room or lateral space between two pairs of pillars  / classifier for rooms<br /><br />gap  / to separate  / to thin out (seedlings)  / to sow discontent
箱		xiāng 	box  / trunk  / chest
位		wèi 	position  / location  / place  / seat  / classifier for people (honorific)  / classifier for binary bits (e.g. 十六位 16-bit or 2 bytes)  / (physics) potential
等		děng 	class  / rank  / grade  / equal to  / same as  / to wait for  / to await  / et cetera  / and so on  / et al. (and other authors)  / after  / as soon as  / once
一下		yī xià 	(used after a verb) give it a go  / to do (sth for a bit to give it a try)  / one time  / once  / in a while  / all of a sudden  / all at once
进	進	jìn 	to go forward  / to advance  / to go in  / to enter  / to put in  / to submit  / to take in  / to admit  / (math.) base of a number system  / classifier for sections in a building or residential compound
坐		Zuò <br /><br />zuò 	surname Zuo<br /><br />to sit  / to take a seat  / to take (a bus, airplane etc)  / to bear fruit  / variant of 座
菜单	菜單	cài dān 	menu  / CL: 份, 張｜张
英文		Yīng wén 	English (language)
菜		cài 	dish (type of food)  / vegetable  / cuisine  / CL: 盤｜盘, 道 / (coll.) (one's) type  / (of one's skills etc) weak  / poor
单	單	Shàn <br /><br />dān 	surname Shan<br /><br />bill  / list  / form  / single  / only  / sole  / odd number  / CL: 個｜个
英		Yīng <br /><br />yīng 	United Kingdom  / British  / England  / English  / abbr. for 英國｜英国<br /><br />hero  / outstanding  / excellent  / (literary) flower  / blossom
文		Wén <br /><br />wén 	surname Wen<br /><br />language  / culture  / writing  / formal  / literary  / gentle  / (old) classifier for coins  / Kangxi radical 67
服务员	服務員	fú wù yuán 	waiter  / waitress  / attendant  / customer service personnel  / CL: 個｜个, 位
点菜	點菜	diǎn cài 	to order dishes (in a restaurant)
买单	買單	mǎi dān 	to pay the restaurant bill
订位	訂位	dìng wèi 	to reserve a seat  / to book a table  / reservation
服		fú <br /><br />fù 	clothes  / dress  / garment  / to serve (in the military, a prison sentence etc)  / to obey  / to be convinced (by an argument)  / to convince  / to admire  / to acclimatize  / to take (medicine)  / mourning clothes  / to wear mourning clothes<br /><br />dose (measure word for medicine)  / Taiwan pr. [fu2]
务	務	wù 	affair  / business  / matter  / to be engaged in  / to attend to  / by all means
员	員	yuán 	person  / employee  / member
订	訂	dìng 	to agree  / to conclude  / to draw up  / to subscribe to (a newspaper etc)  / to order
些		xiē 	some  / few  / several  / measure word indicating a small amount or small number (greater than 1)
西		Xī <br /><br />xī 	the West  / abbr. for Spain 西班牙 / Spanish<br /><br />west
东	東	Dōng <br /><br />dōng 	surname Dong<br /><br />east  / host (i.e. sitting on east side of guest)  / landlord
东西	東西	dōng xī <br /><br />dōng xi 	east and west<br /><br />thing  / stuff  / person  / CL: 個｜个, 件
帮	幫	bāng 	to help  / to assist  / to support  / for sb (i.e. as a help)  / hired (as worker)  / side (of pail, boat etc)  / outer layer  / upper (of a shoe)  / group  / gang  / clique  / party  / secret society
超市		chāo shì 	supermarket  / abbr. for 超級市場｜超级市场 / CL: 家
水果		shuǐ guǒ 	fruit  / CL: 個｜个
超		chāo 	to exceed  / to overtake  / to surpass  / to transcend  / to pass  / to cross  / ultra-  / super-
市		shì 	market  / city  / CL: 個｜个
果		guǒ 	fruit  / result  / resolute  / indeed  / if really
给	給	gěi <br /><br />jǐ 	to  / for  / for the benefit of  / to give  / to allow  / to do sth (for sb)  / (grammatical equivalent of 被)  / (grammatical equivalent of 把)  / (sentence intensifier)<br /><br />to supply  / to provide
苹果	蘋果	píng guǒ 	apple  / CL: 個｜个, 顆｜颗
西瓜		xī guā 	watermelon  / CL: 顆｜颗, 粒, 個｜个
苹		píng <br /><br />pín <br /><br />píng 	(artemisia)  / duckweed<br /><br />marsiliaceae  / clover fern<br /><br />apple
瓜		guā 	melon  / gourd  / squash
鸡蛋	雞蛋	jī dàn 	(chicken) egg  / hen's egg  / CL: 個｜个, 打
新鲜	新鮮	xīn xiān 	fresh (experience, food etc)  / freshness  / novel  / uncommon
鸡	雞	jī 	fowl  / chicken  / CL: 隻｜只 / (slang) prostitute
蛋		dàn 	egg  / CL: 個｜个, 打 / oval-shaped thing
鲜	鮮	xiān <br /><br />xiǎn <br /><br />xiān 	fresh  / bright (in color)  / delicious  / tasty  / delicacy  / aquatic foods<br /><br />few  / rare<br /><br />fish  / old variant of 鮮｜鲜
蔬菜		shū cài 	vegetables  / produce  / CL: 種｜种
蔬		shū 	vegetables
包		Bāo <br /><br />bāo 	surname Bao<br /><br />to cover  / to wrap  / to hold  / to include  / to take charge of  / to contract (to or for)  / package  / wrapper  / container  / bag  / to hold or embrace  / bundle  / packet  / CL: 個｜个, 隻｜只
米		Mǐ <br /><br />mǐ 	surname Mi<br /><br />rice  / CL: 粒 / meter (classifier)
面包	麵包	miàn bāo 	bread  / CL: 片, 袋, 塊｜块
袋		dài 	pouch  / bag  / sack  / pocket
糖		táng 	sugar  / sweets  / candy  / CL: 顆｜颗, 塊｜块
为	為	wéi <br /><br />wèi 	as (in the capacity of)  / to take sth as  / to act as  / to serve as  / to behave as  / to become  / to be  / to do  / by (in the passive voice)<br /><br />because of  / for  / to
文		Wén <br /><br />wén 	surname Wen<br /><br />language  / culture  / writing  / formal  / literary  / gentle  / (old) classifier for coins  / Kangxi radical 67
习	習	Xí <br /><br />xí 	surname Xi<br /><br />to practice  / to study  / habit
学习	學習	xué xí 	to learn  / to study
中文		Zhōng wén 	Chinese language
为什么	為什麼	wèi shén me 	why?  / for what reason?
去		qù 	to go  / to go to (a place)  / (of a time etc) last  / just passed  / to send  / to remove  / to get rid of  / to reduce  / to be apart from in space or time  / to die (euphemism)  / to play (a part)  / (when used either before or after a verb) to go in order to do sth  / (after a verb of motion indicates movement away from the speaker)  / (used after certain verbs to indicate detachment or separation)
因为	因為	yīn wèi 	because  / owing to  / on account of
所以		suǒ yǐ 	therefore  / as a result  / so  / the reason why
西班牙		Xī bān yá 	Spain
因		yīn 	cause  / reason  / because
所		suǒ 	actually  / place  / classifier for houses, small buildings, institutions etc  / that which  / particle introducing a relative clause or passive  / CL: 個｜个
以		Yǐ <br /><br />yǐ 	abbr. for Israel 以色列<br /><br />to use  / by means of  / according to  / in order to  / because of  / at (a certain date or place)
西		Xī <br /><br />xī 	the West  / abbr. for Spain 西班牙 / Spanish<br /><br />west
班		Bān <br /><br />bān 	surname Ban<br /><br />team  / class  / squad  / work shift  / ranking  / CL: 個｜个 / classifier for groups
牙		yá 	tooth  / ivory  / CL: 顆｜颗
旅游	旅遊	lǚ yóu 	trip  / journey  / tourism  / travel  / tour  / to travel
爱好	愛好	ài hào 	to like  / to take pleasure in  / keen on  / fond of  / interest  / hobby  / appetite for  / CL: 個｜个
新		Xīn <br /><br />xīn 	abbr. for Xinjiang 新疆 or Singapore 新加坡 / surname Xin<br /><br />new  / newly  / meso- (chemistry)
西班牙语	西班牙語	Xī bān yá yǔ 	Spanish language
轻松	輕鬆	qīng sōng 	light  / gentle  / relaxed  / effortless  / uncomplicated  / to relax  / to take things less seriously
旅		lǚ 	trip  / travel  / to travel  / brigade (army)
好		hǎo <br /><br />hào 	good  / well  / proper  / good to  / easy to  / very  / so  / (suffix indicating completion or readiness)  / (of two people) close  / on intimate terms<br /><br />to be fond of  / to have a tendency to  / to be prone to
轻	輕	qīng 	light  / easy  / gentle  / soft  / reckless  / unimportant  / frivolous  / small in number  / unstressed  / neutral  / to disparage
松		Sōng <br /><br />sōng <br /><br />sōng 	surname Song<br /><br />pine  / CL: 棵<br /><br />loose  / to loosen  / to relax
照相机	照相機	zhào xiàng jī 	camera  / CL: 個｜个, 架, 部, 台, 隻｜只
印度		Yìn dù 	India
拍照		pāi zhào 	to take a picture
拍		pāi 	to pat  / to clap  / to slap  / to swat  / to take (a photo)  / to shoot (a film)  / racket (sports)  / beat (music)
照		zhào 	according to  / in accordance with  / to shine  / to illuminate  / to reflect  / to look at (one's reflection)  / to take (a photo)  / photo  / as requested  / as before
印		Yìn <br /><br />yìn 	surname Yin  / abbr. for 印度<br /><br />to print  / to mark  / to engrave  / a seal  / a print  / a stamp  / a mark  / a trace  / image
相		Xiāng <br /><br />xiāng <br /><br />xiàng 	surname Xiang<br /><br />each other  / one another  / mutually<br /><br />appearance  / portrait  / picture  / government minister  / (physics) phase  / (literary) to appraise (esp. by scrutinizing physical features)  / to read sb's fortune (by physiognomy, palmistry etc)
度		dù <br /><br />duó 	to pass  / to spend (time)  / measure  / limit  / extent  / degree of intensity  / degree (angles, temperature etc)  / kilowatt-hour  / classifier for events and occurrences<br /><br />to estimate  / Taiwan pr. [duo4]
海		Hǎi <br /><br />hǎi 	surname Hai<br /><br />ocean  / sea  / CL: 個｜个, 片 / great number of people or things  / (dialect) numerous
本		běn 	root  / stem  / origin  / source  / this  / the current  / original  / inherent  / originally  / classifier for books, periodicals, files etc
还	還	Huán <br /><br />hái <br /><br />huán 	surname Huan<br /><br />still  / still in progress  / still more  / yet  / even more  / in addition  / fairly  / passably (good)  / as early as  / even  / also  / else<br /><br />to pay back  / to return
上海		Shàng hǎi 	Shanghai municipality, central east China, abbr. to 滬｜沪
菜		cài 	dish (type of food)  / vegetable  / cuisine  / CL: 盤｜盘, 道 / (coll.) (one's) type  / (of one's skills etc) weak  / poor
还是	還是	hái shi 	or  / still  / nevertheless  / had better
日本		Rì běn 	Japan  / Japanese
肉		ròu 	meat  / flesh  / pulp (of a fruit)  / (coll.) (of a fruit) squashy  / (of a person) flabby  / irresolute
米饭	米飯	mǐ fàn 	(cooked) rice
面条	麵條	miàn tiáo 	noodles
鸡肉	雞肉	jī ròu 	chicken meat
牛肉		niú ròu 	beef
猪肉	豬肉	zhū ròu 	pork
羊肉		yáng ròu 	mutton  / goat meat
饮料	飲料	yǐn liào 	drink  / beverage
猪	豬	zhū 	hog  / pig  / swine  / CL: 口, 頭｜头
羊		Yáng <br /><br />yáng 	surname Yang<br /><br />sheep  / goat  / CL: 頭｜头, 隻｜只
饮	飲	yǐn <br /><br />yìn 	to drink<br /><br />to give (animals) water to drink
料		liào 	material  / stuff  / grain  / feed  / to expect  / to anticipate  / to guess
作		zuō <br /><br />zuò 	worker  / workshop  / (slang) troublesome  / high-maintenance (person)<br /><br />to do  / to grow  / to write or compose  / to pretend  / to regard as  / to feel  / writings or works
得		dé <br /><br />de <br /><br />děi 	to obtain  / to get  / to gain  / to catch (a disease)  / proper  / suitable  / proud  / contented  / to allow  / to permit  / ready  / finished<br /><br />structural particle: used after a verb (or adjective as main verb), linking it to following phrase indicating effect, degree, possibility etc<br /><br />to have to  / must  / ought to  / to need to
觉	覺	jiào <br /><br />jué 	a nap  / a sleep  / CL: 場｜场<br /><br />to feel  / to find that  / thinking  / awake  / aware
工		gōng 	work  / worker  / skill  / profession  / trade  / craft  / labor
累		lěi <br /><br />lèi <br /><br />Léi <br /><br />léi 	to accumulate  / to involve or implicate (Taiwan pr. [lei4])  / continuous  / repeated<br /><br />tired  / weary  / to strain  / to wear out  / to work hard<br /><br />surname Lei<br /><br />rope  / to bind together  / to twist around
工作		gōng zuò 	to work  / (of a machine) to operate  / job  / work  / task  / CL: 個｜个, 份, 項｜项
觉得	覺得	jué de 	to think  / to feel
有点儿	有點兒	yǒu diǎnr 	slightly  / a little  / somewhat
胖		pán <br /><br />pàng 	healthy  / at ease<br /><br />fat  / plump
健康		jiàn kāng 	health  / healthy
不要		bù yào 	don't!  / must not
健		jiàn 	healthy  / to invigorate  / to strengthen  / to be good at  / to be strong in
康		Kāng <br /><br />kāng 	surname Kang<br /><br />healthy  / peaceful  / abundant
身体	身體	shēn tǐ 	the body  / one's health  / CL: 具, 個｜个 / in person
注意		zhù yì 	to take note of  / to pay attention to
身		shēn 	body  / life  / oneself  / personally  / one's morality and conduct  / the main part of a structure or body  / pregnant  / classifier for sets of clothes: suit, twinset  / Kangxi radical 158
注		zhù <br /><br />zhù 	to inject  / to pour into  / to concentrate  / to pay attention  / stake (gambling)  / classifier for sums of money  / variant of 註｜注<br /><br />to register  / to annotate  / note  / comment
意		Yì <br /><br />yì 	Italy  / Italian  / abbr. for 意大利<br /><br />idea  / meaning  / thought  / to think  / wish  / desire  / intention  / to expect  / to anticipate
开始	開始	kāi shǐ 	to begin  / beginning  / to start  / initial  / CL: 個｜个
锻炼	鍛鍊	duàn liàn 	to toughen  / to temper  / to engage in physical exercise  / to work out  / (fig.) to develop one's skills  / to train oneself
开	開	kāi 	to open  / to start  / to turn on  / to boil  / to write out (a prescription, check, invoice etc)  / to operate (a vehicle)  / carat (gold)  / abbr. for Kelvin, 開爾文｜开尔文 / abbr. for 開本｜开本, book format
锻	鍛	duàn 	to forge  / to discipline  / wrought
始		shǐ 	to begin  / to start  / then  / only then
炼	煉	liàn 	to refine  / to smelt
铁	鐵	Tiě <br /><br />tiě 	surname Tie<br /><br />iron (metal)  / arms  / weapons  / hard  / strong  / violent  / unshakeable  / determined  / close  / tight (slang)
店		diàn 	inn  / shop  / store  / CL: 家
地		de <br /><br />dì 	-ly  / structural particle: used before a verb or adjective, linking it to preceding modifying adverbial adjunct<br /><br />earth  / ground  / field  / place  / land  / CL: 片
酒		jiǔ 	wine (esp. rice wine)  / liquor  / spirits  / alcoholic beverage  / CL: 杯, 瓶, 罐, 桶, 缸
酒店		jiǔ diàn 	wine shop  / pub (public house)  / hotel  / restaurant  / (Tw) hostess club
地铁	地鐵	dì tiě 	subway  / metro
坐		Zuò <br /><br />zuò 	surname Zuo<br /><br />to sit  / to take a seat  / to take (a bus, airplane etc)  / to bear fruit  / variant of 座
不准		bù zhǔn 	not to allow  / to forbid  / to prohibit
准		zhǔn <br /><br />zhǔn 	to allow  / to grant  / in accordance with  / in the light of<br /><br />accurate  / standard  / definitely  / certainly  / about to become (bride, son-in-law etc)  / quasi-  / para-
出租车	出租車	chū zū chē 	taxi  / (Taiwan) rental car
站		zhàn 	station  / to stand  / to halt  / to stop  / branch of a company or organization  / website
下		xià 	down  / downwards  / below  / lower  / later  / next (week etc)  / second (of two parts)  / to decline  / to go down  / to arrive at (a decision, conclusion etc)  / measure word to show the frequency of an action
车	車	Chē <br /><br />chē <br /><br />jū 	surname Che<br /><br />car  / vehicle  / CL: 輛｜辆 / machine  / to shape with a lathe<br /><br />war chariot (archaic)  / rook (in Chinese chess)  / rook (in chess)
出		chū 	to go out  / to come out  / to occur  / to produce  / to go beyond  / to rise  / to put forth  / to happen  / (used after a verb to indicate an outward direction or a positive result)  / classifier for dramas, plays, operas etc
租		zū 	to hire  / to rent  / to charter  / to rent out  / to lease out  / rent  / land tax
可以		kě yǐ 	can  / may  / possible  / able to  / not bad  / pretty good
汽车	汽車	qì chē 	car  / automobile  / bus  / CL: 輛｜辆
公共		gōng gòng 	public  / common  / communal
船		chuán 	boat  / vessel  / ship  / CL: 條｜条, 艘, 隻｜只
公		gōng 	public  / collectively owned  / common  / international (e.g. high seas, metric system, calendar)  / make public  / fair  / just  / Duke, highest of five orders of nobility 五等爵位 / honorable (gentlemen)  / father-in-law  / male (animal)
汽		qì 	steam  / vapor
件		jiàn 	item  / component  / classifier for events, things, clothes etc
衣		yī <br /><br />yì 	clothes  / CL: 件<br /><br />to dress  / to wear  / to put on (clothes)
商		Shāng <br /><br />shāng 	Shang Dynasty (c. 1600-1046 BC)  / surname Shang<br /><br />commerce  / merchant  / dealer  / to consult  / 2nd note in pentatonic scale  / quotient (as in 智商, intelligence quotient)
商店		shāng diàn 	store  / shop  / CL: 家, 個｜个
衣服		yī fu 	clothes  / CL: 件, 套
开	開	kāi 	to open  / to start  / to turn on  / to boil  / to write out (a prescription, check, invoice etc)  / to operate (a vehicle)  / carat (gold)  / abbr. for Kelvin, 開爾文｜开尔文 / abbr. for 開本｜开本, book format
关	關	Guān <br /><br />guān 	surname Guan<br /><br />mountain pass  / to close  / to shut  / to turn off  / to concern  / to involve
门	門	Mén <br /><br />mén 	surname Men<br /><br />gate  / door  / CL: 扇 / gateway  / doorway  / CL: 個｜个 / opening  / valve  / switch  / way to do something  / knack  / family  / house  / (religious) sect  / school (of thought)  / class  / category  / phylum or division (taxonomy)  / classifier for large guns  / classifier for lessons, subjects, branches of technology  / (suffix) -gate (i.e. scandal; derived from Watergate)
欢迎	歡迎	huān yíng 	to welcome  / welcome
迎		yíng 	to welcome  / to meet  / to face  / to forge ahead (esp. in the face of difficulties)
您		nín 	you (courteous, as opposed to informal 你)
帮忙	幫忙	bāng máng 	to help  / to lend a hand  / to do a favor  / to do a good turn
需要		xū yào 	to need  / to want  / to demand  / to require  / requirement  / need
需		xū 	to require  / to need  / to want  / necessity  / need
随便	隨便	suí biàn 	as one wishes  / as one pleases  / at random  / negligent  / casual  / wanton
随	隨	Suí <br /><br />suí 	surname Sui<br /><br />to follow  / to comply with  / varying according to...  / to allow  / subsequently
便		biàn <br /><br />pián 	plain  / informal  / suitable  / convenient  / opportune  / to urinate or defecate  / equivalent to 就: then  / in that case  / even if  / soon afterwards<br /><br />see 便宜
字		zì 	letter  / symbol  / character  / word  / CL: 個｜个 / courtesy or style name traditionally given to males aged 20 in dynastic China
读	讀	dòu <br /><br />dú 	comma  / phrase marked by pause<br /><br />to read  / to study  / reading of word (i.e. pronunciation), similar to 拼音
一点儿		yī diǎnr 	erhua variant of 一點｜一点 
意思		yì si 	idea  / opinion  / meaning  / wish  / desire  / interest  / fun  / token of appreciation, affection etc  / CL: 個｜个 / to give as a small token  / to do sth as a gesture of goodwill etc
写	寫	xiě 	to write
错	錯	Cuò <br /><br />cuò 	surname Cuo<br /><br />mistake  / wrong  / bad  / interlocking  / complex  / to grind  / to polish  / to alternate  / to stagger  / to miss  / to let slip  / to evade  / to inlay with gold or silver
难	難	nán <br /><br />nàn 	difficult (to...)  / problem  / difficulty  / difficult  / not good<br /><br />disaster  / distress  / to scold
思		sī 	to think  / to consider
秒		miǎo 	second (unit of time)  / arc second (angular measurement unit)  / (coll.) instantly
刻		kè 	quarter (hour)  / moment  / to carve  / to engrave  / to cut  / oppressive  / classifier for short time intervals
差		chā <br /><br />chà <br /><br />chāi 	difference  / discrepancy  / to differ  / error  / to err  / to make a mistake<br /><br />to differ from  / to fall short of  / lacking  / wrong  / inferior<br /><br />to send  / to commission  / messenger  / mission
小时	小時	xiǎo shí 	hour  / CL: 個｜个
分钟	分鐘	fēn zhōng 	minute
小		xiǎo 	small  / tiny  / few  / young
时	時	Shí <br /><br />shí 	surname Shi<br /><br />o'clock  / time  / when  / hour  / season  / period
钟	鍾	Zhōng <br /><br />zhōng <br /><br />zhōng 	surname Zhong<br /><br />handleless cup  / goblet  / to concentrate  / variant of 鐘｜钟<br /><br />clock  / o'clock  / time as measured in hours and minutes  / bell  / CL: 架, 座
钟	鍾	Zhōng <br /><br />zhōng <br /><br />zhōng 	surname Zhong<br /><br />handleless cup  / goblet  / to concentrate  / variant of 鐘｜钟<br /><br />clock  / o'clock  / time as measured in hours and minutes  / bell  / CL: 架, 座
整		zhěng 	exactly  / in good order  / whole  / complete  / entire  / in order  / orderly  / to repair  / to mend  / to renovate  / (coll.) to fix sb  / to give sb a hard time  / to mess with sb
早		zǎo 	early  / morning  / Good morning!  / long ago  / prematurely
晚		wǎn 	evening  / night  / late
杯		bēi 	cup  / trophy cup  / classifier for certain containers of liquids: glass, cup
啤		pí 	beer
德		Dé <br /><br />dé 	Germany  / German  / abbr. for 德國｜德国<br /><br />virtue  / goodness  / morality  / ethics  / kindness  / favor  / character  / kind
德国	德國	Dé guó 	Germany  / German
啤酒		pí jiǔ 	beer (loanword)  / CL: 杯, 瓶, 罐, 桶, 缸
果汁		guǒ zhī 	fruit juice
汁		zhī 	juice
香蕉		xiāng jiāo 	banana  / CL: 枝, 根, 個｜个, 把
蛋糕		dàn gāo 	cake  / CL: 塊｜块, 個｜个
块	塊	kuài 	lump (of earth)  / chunk  / piece  / classifier for pieces of cloth, cake, soap etc  / (coll.) classifier for money and currency units
香		xiāng 	fragrant  / sweet smelling  / aromatic  / savory or appetizing  / (to eat) with relish  / (of sleep) sound  / perfume or spice  / joss or incense stick  / CL: 根
蕉		jiāo <br /><br />qiáo 	banana<br /><br />see 蕉萃
糕		gāo 	cake
碗		wǎn 	bowl  / cup  / CL: 隻｜只, 個｜个
杯子		bēi zi 	cup  / glass  / CL: 個｜个, 隻｜只
盘子	盤子	pán zi 	tray  / plate  / dish  / CL: 個｜个
盘	盤	pán 	plate  / dish  / tray  / board  / hard drive (computing)  / to build  / to coil  / to check  / to examine  / to transfer (property)  / to make over  / classifier for food: dish, helping  / to coil  / classifier for coils of wire  / classifier for games of chess
筷子		kuài zi 	chopsticks  / CL: 對｜对, 根, 把, 雙｜双
刀		Dāo <br /><br />dāo 	surname Dao<br /><br />knife  / blade  / single-edged sword  / cutlass  / CL: 把 / (slang) dollar (loanword)  / classifier for sets of one hundred sheets (of paper)  / classifier for knife cuts or stabs
叉		chā <br /><br />chá <br /><br />chǎ 	fork  / pitchfork  / prong  / pick  / cross  / intersect  / "X"<br /><br />to cross  / be stuck<br /><br />to diverge  / to open (as legs)
筷		kuài 	chopstick
勺子		sháo zi 	scoop  / ladle  / CL: 把
勺		sháo 	spoon  / ladle  / CL: 把 / abbr. for 公勺, centiliter (unit of volume)
室		Shì <br /><br />shì 	surname Shi<br /><br />room  / work unit  / grave  / scabbard  / family or clan  / one of the 28 constellations of Chinese astronomy
办	辦	bàn 	to do  / to manage  / to handle  / to go about  / to run  / to set up  / to deal with
辆	輛	liàng 	classifier for vehicles
办公室	辦公室	bàn gōng shì 	office  / business premises  / bureau  / CL: 間｜间
本		běn 	root  / stem  / origin  / source  / this  / the current  / original  / inherent  / originally  / classifier for books, periodicals, files etc
瓶子		píng zi 	bottle  / CL: 個｜个
张	張	Zhāng <br /><br />zhāng 	surname Zhang<br /><br />to open up  / to spread  / sheet of paper  / classifier for flat objects, sheet  / classifier for votes
照片		zhào piàn 	photograph  / picture  / CL: 張｜张, 套, 幅
瓶		píng 	bottle  / vase  / pitcher  / CL: 個｜个 / classifier for wine and liquids
片		piān <br /><br />piàn 	disk  / sheet<br /><br />thin piece  / flake  / a slice  / film  / TV play  / to slice  / to carve thin  / partial  / incomplete  / one-sided  / classifier for slices, tablets, tract of land, area of water  / classifier for CDs, movies, DVDs etc  / used with numeral 一: classifier for scenario, scene, feeling, atmosphere, sound etc
只		zhǐ <br /><br />zhǐ <br /><br />zhī 	only  / merely  / just  / but<br /><br />grain that has begun to ripen  / variant of 衹｜只<br /><br />classifier for birds and certain animals, one of a pair, some utensils, vessels etc
鸟	鳥	niǎo 	bird  / CL: 隻｜只, 群 / (dialect) to pay attention to  / (intensifier) damned  / goddam
树	樹	shù 	tree  / CL: 棵 / to cultivate  / to set up
步		Bù <br /><br />bù 	surname Bu<br /><br />a step  / a pace  / walk  / march  / stages in a process  / situation
跑		páo <br /><br />pǎo 	(of an animal) to paw (the ground)<br /><br />to run  / to run away  / to escape  / to run around (on errands etc)  / (of a gas or liquid) to leak or evaporate  / (verb complement) away  / off
泳		yǒng 	swimming  / to swim
游		Yóu <br /><br />yóu <br /><br />yóu 	surname You<br /><br />to swim  / variant of 遊｜游<br /><br />to walk  / to tour  / to roam  / to travel
游泳		yóu yǒng 	swimming  / to swim
跑步		pǎo bù 	to run  / to jog  / (military) to march at the double
踢		tī 	to kick  / to play (e.g. soccer)  / (slang) butch (in a lesbian relationship)
足球		zú qiú 	soccer ball  / a football  / CL: 個｜个 / soccer  / football
打		dá <br /><br />dǎ 	dozen (loanword)<br /><br />to beat  / to strike  / to hit  / to break  / to type  / to mix up  / to build  / to fight  / to fetch  / to make  / to tie up  / to issue  / to shoot  / to calculate  / to play (a game)  / since  / from
篮球	籃球	lán qiú 	basketball  / CL: 個｜个, 隻｜只
足		jù <br /><br />zú 	excessive<br /><br />foot  / to be sufficient  / ample
篮	籃	lán 	basket (receptacle)  / basket (in basketball)
球		qiú 	ball  / sphere  / globe  / CL: 個｜个 / ball game  / match  / CL: 場｜场
运动	運動	yùn dòng 	to move  / to exercise  / sports  / exercise  / motion  / movement  / campaign  / CL: 場｜场
马	馬	Mǎ <br /><br />mǎ 	surname Ma  / abbr. for Malaysia 馬來西亞｜马来西亚<br /><br />horse  / CL: 匹 / horse or cavalry piece in Chinese chess  / knight in Western chess
骑	騎	jì <br /><br />qí 	(Taiwan) saddle horse  / mounted soldier<br /><br />to ride (an animal or bike)  / to sit astride  / classifier for saddle-horses
运	運	yùn 	to move  / to transport  / to use  / to apply  / fortune  / luck  / fate
动	動	dòng 	(of sth) to move  / to set in movement  / to displace  / to touch  / to make use of  / to stir (emotions)  / to alter  / abbr. for 動詞｜动词, verb
吧		bā <br /><br />ba 	bar (loanword) (serving drinks, or providing Internet access etc)  / to puff (on a pipe etc)  / (onom.) bang  / abbr. for 貼吧｜贴吧<br /><br />(modal particle indicating suggestion or surmise)  / ...right?  / ...OK?  / ...I presume.
出去		chū qù 	to go out
时间	時間	shí jiān 	time  / period  / CL: 段
时候	時候	shí hou 	time  / length of time  / moment  / period
空		kōng <br /><br />kòng 	empty  / air  / sky  / in vain<br /><br />to empty  / vacant  / unoccupied  / space  / leisure  / free time
请	請	qǐng 	to ask  / to invite  / please (do sth)  / to treat (to a meal etc)  / to request
来	來	lái 	to come  / to arrive  / to come round  / ever since  / next
候		hòu 	to wait  / to inquire after  / to watch  / season  / climate  / (old) period of five days
过	過	Guò <br /><br />guò <br /><br />guo 	surname Guo<br /><br />to cross  / to go over  / to pass (time)  / to celebrate (a holiday)  / to live  / to get along  / excessively  / too-<br /><br />(experienced action marker)
一起		yī qǐ 	in the same place  / together  / with  / altogether (in total)
家	傢	jiā <br /><br />Jiā <br /><br />jiā 	see 傢伙｜家伙<br /><br />surname Jia<br /><br />home  / family  / (polite) my (sister, uncle etc)  / classifier for families or businesses  / refers to the philosophical schools of pre-Han China  / noun suffix for a specialist in some activity, such as a musician or revolutionary, corresponding to English -ist, -er, -ary or -ian  / CL: 個｜个
不好意思		bù hǎo yì si 	to feel embarrassed  / to find it embarrassing  / to be sorry (for inconveniencing sb)
给	給	gěi <br /><br />jǐ 	to  / for  / for the benefit of  / to give  / to allow  / to do sth (for sb)  / (grammatical equivalent of 被)  / (grammatical equivalent of 把)  / (sentence intensifier)<br /><br />to supply  / to provide
告诉	告訴	gào sù <br /><br />gào su 	to press charges  / to file a complaint<br /><br />to tell  / to inform  / to let know
告		gào 	to say  / to tell  / to announce  / to report  / to denounce  / to file a lawsuit  / to sue
诉	訴	sù 	to complain  / to sue  / to tell
约会	約會	yuē huì 	appointment  / engagement  / date  / CL: 次, 個｜个 / to arrange to meet
浪漫		làng màn 	romantic
浪		làng 	wave  / breaker  / unrestrained  / dissipated
漫		màn 	free  / unrestrained  / to inundate
该	該	gāi 	should  / ought to  / probably  / must be  / to deserve  / to owe  / to be sb's turn to do sth  / that  / the above-mentioned
病		bìng 	illness  / CL: 場｜场 / disease  / to fall ill  / defect
舒		Shū <br /><br />shū 	surname Shu<br /><br />to stretch  / to unfold  / to relax  / leisurely
应	應	Yìng <br /><br />yīng <br /><br />yìng 	surname Ying<br /><br />to agree (to do sth)  / should  / ought to  / must  / (legal) shall<br /><br />to answer  / to respond  / to comply with  / to deal or cope with
生病		shēng bìng 	to fall ill
应该	應該	yīng gāi 	ought to  / should  / must
舒服		shū fu 	comfortable  / feeling well
了		le <br /><br />liǎo <br /><br />liǎo 	(modal particle intensifying preceding clause)  / (completed action marker)<br /><br />to finish  / to achieve  / variant of 瞭｜了 / to understand clearly<br /><br />(of eyes) bright  / clear-sighted  / to understand clearly
疼		téng 	(it) hurts  / sore  / to love dearly
头	頭	tóu <br /><br />tou 	head  / hair style  / the top  / end  / beginning or end  / a stub  / remnant  / chief  / boss  / side  / aspect  / first  / leading  / classifier for pigs or livestock  / CL: 個｜个<br /><br />suffix for nouns
休息		xiū xi 	rest  / to rest
休		Xiū <br /><br />xiū 	surname Xiu<br /><br />to rest  / to stop doing sth for a period of time  / to cease  / (imperative) don't
息		xī 	breath  / news  / interest (on an investment or loan)  / to cease  / to stop  / to rest  / Taiwan pr. [xi2]
肚子		dù zi 	belly  / abdomen  / stomach  / CL: 個｜个
肚		dǔ <br /><br />dù 	tripe<br /><br />belly
药	葯	yào <br /><br />yào 	leaf of the iris  / variant of 藥｜药<br /><br />medicine  / drug  / substance used for a specific purpose (e.g. poisoning, explosion, fermenting)  / CL: 種｜种, 服, 味 / to poison
一定		yī dìng 	surely  / certainly  / necessarily  / fixed  / a certain (extent etc)  / given  / particular  / must
感冒		gǎn mào 	to catch cold  / (common) cold  / CL: 場｜场, 次 / (coll.) to be interested in (often used in the negative)  / (Tw) to detest  / can't stand
感		gǎn 	to feel  / to move  / to touch  / to affect  / feeling  / emotion  / (suffix) sense of ~
定		dìng 	to set  / to fix  / to determine  / to decide  / to order
冒		Mào <br /><br />mào 	surname Mao<br /><br />to emit  / to give off  / to send out (or up, forth)  / to brave  / to face  / reckless  / to falsely adopt (sb's identity etc)  / to feign  / (literary) to cover
留		liú 	to leave (a message etc)  / to retain  / to stay  / to remain  / to keep  / to preserve
请假	請假	qǐng jià 	to request leave of absence
发烧	發燒	fā shāo 	to have a high temperature (from illness)  / to have a fever
别	別	Bié <br /><br />bié <br /><br />biè 	surname Bie<br /><br />to leave  / to depart  / to separate  / to distinguish  / to classify  / other  / another  / don't ...!  / to pin  / to stick (sth) in<br /><br />to make sb change their ways, opinions etc
发	發	fā <br /><br />fà 	to send out  / to show (one's feeling)  / to issue  / to develop  / to make a bundle of money  / classifier for gunshots (rounds)<br /><br />hair  / Taiwan pr. [fa3]
假		jiǎ <br /><br />jià 	fake  / false  / artificial  / to borrow  / if  / suppose<br /><br />vacation
烧	燒	shāo 	to burn  / to cook  / to stew  / to bake  / to roast  / to heat  / to boil (tea, water etc)  / fever  / to run a temperature  / (coll.) to let things go to one's head
派		pài 	clique  / school  / group  / faction  / to dispatch  / to send  / to assign  / to appoint  / pi (Greek letter Ππ)  / the circular ratio pi = 3.1415926  / (loanword) pie
能		Néng <br /><br />néng 	surname Neng<br /><br />can  / to be able to  / might possibly  / ability  / (physics) energy
生日		shēng rì 	birthday  / CL: 個｜个
派对	派對	pài duì 	party (loanword)
打扮		dǎ ban 	to decorate  / to dress  / to make up  / to adorn  / manner of dressing  / style of dress
扮		bàn 	to disguise oneself as  / to dress up  / to play (a role)  / to put on (an expression)
希望		xī wàng 	to wish for  / to desire  / hope  / CL: 個｜个
跟		gēn 	heel  / to follow closely  / to go with  / (of a woman) to marry sb  / with  / compared with  / to  / towards  / and (joining two nouns)
希		xī 	to hope  / to admire  / variant of 稀
望		wàng <br /><br />wàng 	full moon  / to hope  / to expect  / to visit  / to gaze (into the distance)  / to look towards  / towards<br /><br />15th day of month (lunar calendar)  / old variant of 望
大家		dà jiā 	everyone  / influential family  / great expert
公司		gōng sī 	(business) company  / company  / firm  / corporation  / incorporated  / CL: 家
正在		zhèng zài 	just at (that time)  / right in (that place)  / right in the middle of (doing sth)
正		zhēng <br /><br />zhèng 	first month of the lunar year<br /><br />straight  / upright  / proper  / main  / principal  / to correct  / to rectify  / exactly  / just (at that time)  / right (in that place)  / (math.) positive
司		Sī <br /><br />sī 	surname Si<br /><br />to take charge of  / to manage  / department (under a ministry)
事情		shì qing 	affair  / matter  / thing  / business  / CL: 件, 樁｜桩
才		cái <br /><br />cái 	ability  / talent  / sb of a certain type  / a capable individual  / only  / only then  / just now<br /><br />a moment ago  / just now  / (indicating sth happening later than expected)  / (preceded by a clause of condition or reason) not until  / (followed by a numerical clause) only
多		duō 	many  / much  / often  / a lot of  / numerous  / more  / in excess  / how (to what extent)  / multi-  / Taiwan pr. [duo2] when it means "how"
事		shì 	matter  / thing  / item  / work  / affair  / CL: 件, 樁｜桩, 回
情		qíng 	feeling  / emotion  / passion  / situation
费	費	Fèi <br /><br />fèi 	surname Fei<br /><br />to cost  / to spend  / fee  / wasteful  / expenses
完		wán 	to finish  / to be over  / whole  / complete  / entire
经	經	Jīng <br /><br />jīng 	surname Jing<br /><br />classics  / sacred book  / scripture  / to pass through  / to undergo  / to bear  / to endure  / warp (textile)  / longitude  / menstruation  / channel (TCM)  / abbr. for economics 經濟｜经济
已		yǐ 	already  / to stop  / then  / afterwards
已经	已經	yǐ jīng 	already
请	請	qǐng 	to ask  / to invite  / please (do sth)  / to treat (to a meal etc)  / to request
小费	小費	xiǎo fèi 	tip  / gratuity
饱	飽	bǎo 	to eat till full  / satisfied
好吃		hǎo chī <br /><br />hào chī 	tasty  / delicious<br /><br />to be fond of eating  / to be gluttonous
真		zhēn 	really  / truly  / indeed  / real  / true  / genuine
饿	餓	è 	to be hungry  / hungry  / to starve (sb)
少		shǎo <br /><br />shào 	few  / less  / to lack  / to be missing  / to stop (doing sth)  / seldom<br /><br />young
好喝		hǎo hē 	tasty (drinks)
渴		kě 	thirsty
酒		jiǔ 	wine (esp. rice wine)  / liquor  / spirits  / alcoholic beverage  / CL: 杯, 瓶, 罐, 桶, 缸
巧克力		qiǎo kè lì 	chocolate (loanword)  / CL: 塊｜块
味道		wèi dao 	flavor  / smell  / hint of
甜点	甜點	tián diǎn 	dessert
甜		tián 	sweet
巧		qiǎo 	opportunely  / coincidentally  / as it happens  / skillful  / timely
克		kè <br /><br />Kè <br /><br />kēi 	to be able to  / to subdue  / to restrain  / to overcome  / gram  / Tibetan unit of land area, about 6 ares<br /><br />Ke (c. 2000 BC), seventh of the legendary Flame Emperors, 炎帝 descended from Shennong 神農｜神农 Farmer God<br /><br />to scold  / to beat
力		Lì <br /><br />lì 	surname Li<br /><br />power  / force  / strength  / ability  / strenuously
试	試	shì 	to test  / to try  / experiment  / examination  / test
蓝	藍	Lán <br /><br />lán 	surname Lan<br /><br />blue  / indigo plant
条	條	tiáo 	strip  / item  / article  / clause (of law or treaty)  / classifier for long thin things (ribbon, river, road, trousers etc)
裙		qún 	skirt  / CL: 條｜条
裙子		qún zi 	skirt  / CL: 條｜条
双	雙	Shuāng <br /><br />shuāng 	surname Shuang<br /><br />two  / double  / pair  / both  / even (number)
还	還	Huán <br /><br />hái <br /><br />huán 	surname Huan<br /><br />still  / still in progress  / still more  / yet  / even more  / in addition  / fairly  / passably (good)  / as early as  / even  / also  / else<br /><br />to pay back  / to return
鞋子		xié zi 	shoe
意大利		Yì dà lì 	Italy  / Italian
色		sè <br /><br />shǎi 	color  / CL: 種｜种 / look  / appearance  / sex<br /><br />color  / dice
鞋		xié 	shoe  / CL: 雙｜双, 隻｜只
利		Lì <br /><br />lì 	surname Li<br /><br />sharp  / favorable  / advantage  / benefit  / profit  / interest  / to do good to  / to benefit
小		xiǎo 	small  / tiny  / few  / young
比		Bǐ <br /><br />bǐ <br /><br />bì 	Belgium  / Belgian  / abbr. for 比利時｜比利时<br /><br />(particle used for comparison and "-er than")  / to compare  / to contrast  / to gesture (with hands)  / ratio<br /><br />to associate with  / to be near
衬衫	襯衫	chèn shān 	shirt  / blouse  / CL: 件
衬	襯	chèn 	(of garments) against the skin  / to line  / lining  / to contrast with  / to assist financially
衫		shān 	garment  / jacket with open slits in place of sleeves
大		dà <br /><br />dài 	big  / huge  / large  / major  / great  / wide  / deep  / older (than)  / oldest  / eldest  / greatly  / very much  / (dialect) father  / father's elder or younger brother<br /><br />see 大夫
裤子	褲子	kù zi 	trousers  / pants  / CL: 條｜条
好看		hǎo kàn 	good-looking  / nice-looking  / good (of a movie, book, TV show etc)  / embarrassed  / humiliated
裤	褲	kù 	underpants  / trousers  / pants
质	質	zhì 	character  / nature  / quality  / plain  / to pawn  / pledge  / hostage  / to question  / Taiwan pr. [zhi2]
量		liáng <br /><br />liàng 	to measure<br /><br />capacity  / quantity  / amount  / to estimate  / abbr. for 量詞｜量词, classifier (in Chinese grammar)  / measure word
质量	質量	zhì liàng 	quality  / (physics) mass  / CL: 個｜个
朵		duǒ 	flower  / earlobe  / fig. item on both sides  / classifier for flowers, clouds etc
睛		jīng 	eye  / eyeball
绿	綠	lǜ 	green
耳		ěr 	ear  / handle (archaeology)  / and that is all (classical Chinese)
眼		yǎn 	eye  / small hole  / crux (of a matter)  / CL: 隻｜只, 雙｜双 / classifier for big hollow things (wells, stoves, pots etc)
耳朵		ěr duo 	ear  / CL: 隻｜只, 個｜个, 對｜对 / handle (on a cup)
眼睛		yǎn jing 	eye  / CL: 隻｜只, 雙｜双
头发	頭髮	tóu fa 	hair (on the head)
脸	臉	liǎn 	face  / CL: 張｜张, 個｜个
又		yòu 	(once) again  / also  / both... and...  / and yet  / (used for emphasis) anyway
黑		Hēi <br /><br />hēi 	abbr. for Heilongjiang province 黑龍江｜黑龙江<br /><br />black  / dark  / sinister  / secret  / shady  / illegal  / to hide (sth) away  / to vilify  / (loanword) to hack (computing)
发	發	fā <br /><br />fà 	to send out  / to show (one's feeling)  / to issue  / to develop  / to make a bundle of money  / classifier for gunshots (rounds)<br /><br />hair  / Taiwan pr. [fa3]
嘴巴		zuǐ ba 	mouth  / CL: 張｜张 / slap in the face  / CL: 個｜个
鼻子		bí zi 	nose  / CL: 個｜个, 隻｜只
脚	腳	jiǎo 	foot  / leg (of an animal or an object)  / base (of an object)  / CL: 雙｜双, 隻｜只 / classifier for kicks
手		shǒu 	hand  / (formal) to hold  / person engaged in certain types of work  / person skilled in certain types of work  / personal(ly)  / convenient  / classifier for skill  / CL: 雙｜双, 隻｜只
嘴		zuǐ 	mouth  / beak  / nozzle  / spout (of teapot etc)  / CL: 張｜张, 個｜个
鼻		bí 	nose
巴		Bā <br /><br />bā 	Ba state during Zhou dynasty (in east of modern Sichuan)  / abbr. for east Sichuan or Chongqing  / surname Ba  / abbr. for Palestine or Palestinian  / abbr. for Pakistan<br /><br />to long for  / to wish  / to cling to  / to stick to  / sth that sticks  / close to  / next to  / spread open  / informal abbr. for bus 巴士 / bar (unit of pressure)  / nominalizing suffix on certain nouns, such as 尾巴, tail
远	遠	yuǎn <br /><br />yuàn 	far  / distant  / remote  / (intensifier in a comparison) by far  / much (lower etc)<br /><br />to distance oneself from (classical)
离		chī <br /><br />Lí <br /><br />lí 	mythical beast (archaic)<br /><br />surname Li<br /><br />to leave  / to part from  / to be away from  / (in giving distances) from  / without (sth)  / independent of  / one of the Eight Trigrams 八卦, symbolizing fire  / ☲
路		Lù <br /><br />lù 	surname Lu<br /><br />road  / CL: 條｜条 / journey  / route  / line (bus etc)  / sort  / kind
走路		zǒu lù 	to walk  / to go on foot
近		jìn 	near  / close to  / approximately
开车	開車	kāi chē 	to drive a car
飞机	飛機	fēi jī 	airplane  / CL: 架
机场	機場	jī chǎng 	airport  / airfield  / CL: 家, 處｜处
飞	飛	fēi 	to fly
场	場	cháng <br /><br />chǎng 	threshing floor  / classifier for events and happenings: spell, episode, bout<br /><br />large place used for a specific purpose  / stage  / scene (of a play)  / classifier for sporting or recreational activities  / classifier for number of exams
靠		kào 	to lean against or on  / to stand by the side of  / to come near to  / to depend on  / to trust  / to fuck (vulgar)  / traditional military costume drama where the performers wear armor (old)
停		tíng 	to stop  / to halt  / to park (a car)
火车	火車	huǒ chē 	train  / CL: 列, 節｜节, 班, 趟
得		dé <br /><br />de <br /><br />děi 	to obtain  / to get  / to gain  / to catch (a disease)  / proper  / suitable  / proud  / contented  / to allow  / to permit  / ready  / finished<br /><br />structural particle: used after a verb (or adjective as main verb), linking it to following phrase indicating effect, degree, possibility etc<br /><br />to have to  / must  / ought to  / to need to
票		piào 	ticket  / ballot  / banknote  / CL: 張｜张 / person held for ransom  / amateur performance of Chinese opera  / classifier for groups, batches, business transactions
机票	機票	jī piào 	air ticket  / passenger ticket  / CL: 張｜张
火		Huǒ <br /><br />huǒ 	surname Huo<br /><br />fire  / urgent  / ammunition  / fiery or flaming  / internal heat (Chinese medicine)  / hot (popular)  / classifier for military units (old)
迟到	遲到	chí dào 	to arrive late
让	讓	ràng 	to yield  / to permit  / to let sb do sth  / to have sb do sth  / to make sb (feel sad etc)  / by (indicates the agent in a passive clause, like 被)
上		shǎng <br /><br />shàng 	see 上聲｜上声<br /><br />on top  / upon  / above  / upper  / previous  / first (of multiple parts)  / to climb  / to get onto  / to go up  / to attend (class or university)
怎么办	怎麼辦	zěn me bàn 	what's to be done
迟	遲	Chí <br /><br />chí 	surname Chi<br /><br />late  / delayed  / slow
办	辦	bàn 	to do  / to manage  / to handle  / to go about  / to run  / to set up  / to deal with
冷		Lěng <br /><br />lěng 	surname Leng<br /><br />cold
晴		qíng 	clear  / fine (weather)
天气	天氣	tiān qì 	weather
雨		yǔ <br /><br />yù 	rain  / CL: 陣｜阵, 場｜场<br /><br />to rain  / (of rain, snow etc) to fall  / to precipitate  / to wet
雪		Xuě <br /><br />xuě 	surname Xue<br /><br />snow  / snowfall  / CL: 場｜场 / to have the appearance of snow  / to wipe away, off or out  / to clean
阴	陰	Yīn <br /><br />yīn 	surname Yin<br /><br />overcast (weather)  / cloudy  / shady  / Yin (the negative principle of Yin and Yang)  / negative (electric.)  / feminine  / moon  / implicit  / hidden  / genitalia
下		xià 	down  / downwards  / below  / lower  / later  / next (week etc)  / second (of two parts)  / to decline  / to go down  / to arrive at (a decision, conclusion etc)  / measure word to show the frequency of an action
着	著	zhāo <br /><br />zháo <br /><br />zhe <br /><br />zhuó 	(chess) move  / trick  / all right!  / (dialect) to add<br /><br />to touch  / to come in contact with  / to feel  / to be affected by  / to catch fire  / to burn  / (coll.) to fall asleep  / (after a verb) hitting the mark  / succeeding in<br /><br />aspect particle indicating action in progress<br /><br />to wear (clothes)  / to contact  / to use  / to apply
伞	傘	sǎn <br /><br />sǎn 	umbrella  / parasol  / CL: 把<br /><br />damask silk  / variant of 傘｜伞
带	帶	dài 	band  / belt  / girdle  / ribbon  / tire  / area  / zone  / region  / CL: 條｜条 / to wear  / to carry  / to take along  / to bear (i.e. to have)  / to lead  / to bring  / to look after  / to raise
外面		wài miàn 	outside (also pr. [wai4 mian5] for this sense)  / surface  / exterior  / external appearance
可能		kě néng 	might (happen)  / possible  / probable  / possibility  / probability  / maybe  / perhaps  / CL: 個｜个
刮		guā <br /><br />guā 	to scrape  / to blow  / to shave  / to plunder  / to extort<br /><br />to blow (of the wind)
风	風	fēng 	wind  / news  / style  / custom  / manner  / CL: 陣｜阵, 絲｜丝
如果		rú guǒ 	if  / in case  / in the event that
就		jiù 	at once  / right away  / only  / just (emphasis)  / as early as  / already  / as soon as  / then  / in that case  / as many as  / even if  / to approach  / to move towards  / to undertake  / to engage in  / to suffer  / subjected to  / to accomplish  / to take advantage of  / to go with (of foods)  / with regard to  / concerning
从来	從來	cóng lái 	always  / at all times  / never (if used in negative sentence)
如		rú 	as  / as if  / such as
里面	裡面	lǐ miàn 	inside  / interior  / also pr. [li3 mian5]
然		rán 	correct  / right  / so  / thus  / like this  / -ly
但		dàn 	but  / yet  / however  / only  / merely  / still
虽	雖	suī 	although  / even though
短		duǎn 	short  / brief  / to lack  / weak point  / fault
长	長	cháng <br /><br />zhǎng 	length  / long  / forever  / always  / constantly<br /><br />chief  / head  / elder  / to grow  / to develop  / to increase  / to enhance
虽然	雖然	suī rán 	although  / even though  / even if
但是		dàn shì 	but  / however
红	紅	Hóng <br /><br />hóng 	surname Hong<br /><br />red  / popular  / revolutionary  / bonus
颜色	顏色	yán sè 	color  / countenance  / appearance  / facial expression  / pigment  / dyestuff
穿		chuān 	to wear  / to put on  / to dress  / to bore through  / to pierce  / to perforate  / to penetrate  / to pass through  / to thread
颜	顏	Yán <br /><br />yán 	surname Yan<br /><br />color  / face  / countenance
色		sè <br /><br />shǎi 	color  / CL: 種｜种 / look  / appearance  / sex<br /><br />color  / dice
洗		xǐ 	to wash  / to bathe  / to develop (photo)
黄	黃	Huáng <br /><br />huáng 	surname Huang or Hwang<br /><br />yellow  / pornographic  / to fall through
白		Bái <br /><br />bái 	surname Bai<br /><br />white  / snowy  / pure  / bright  / empty  / blank  / plain  / clear  / to make clear  / in vain  / gratuitous  / free of charge  / reactionary  / anti-communist  / funeral  / to stare coldly  / to write wrong character  / to state  / to explain  / vernacular  / spoken lines in opera
黃	-	-
手表	手錶	shǒu biǎo 	wrist watch  / CL: 塊｜块, 隻｜只, 個｜个
卖	賣	mài 	to sell  / to betray  / to spare no effort  / to show off or flaunt
帽子		mào zi 	hat  / cap  / (fig.) label  / bad name  / CL: 頂｜顶
帽		mào 	hat  / cap
表		biǎo <br /><br />biǎo 	exterior surface  / family relationship via females  / to show (one's opinion)  / a model  / a table (listing information)  / a form  / a meter (measuring sth)<br /><br />wrist or pocket watch
紫		zǐ 	purple  / violet  / amethyst  / Lithospermum erythrorhizon (flowering plant whose root provides red purple dye)  / Japanese: murasaki
绍	紹	Shào <br /><br />shào 	surname Shao<br /><br />to continue  / to carry on
介		jiè 	to introduce  / to lie between  / between  / shell  / armor
介绍	介紹	jiè shào 	to introduce (sb to sb)  / to give a presentation  / to present (sb for a job etc)  / introduction
帅	帥	Shuài <br /><br />shuài 	surname Shuai<br /><br />handsome  / graceful  / smart  / commander in chief  / (coll.) cool!  / sweet!
笑		xiào 	laugh  / smile  / CL: 個｜个
说话	說話	shuō huà 	to speak  / to say  / to talk  / to gossip  / to tell stories  / talk  / word
话	話	huà 	dialect  / language  / spoken words  / speech  / talk  / words  / conversation  / what sb said  / CL: 種｜种, 席, 句, 口, 番
聪明	聰明	cōng ming 	intelligent  / clever  / bright  / smart  / acute (of sight and hearing)
别人	別人	bié ren 	other people  / others  / other person
不但		bù dàn 	not only (... but also...)
而且		ér qiě 	(not only ...) but also  / moreover  / in addition  / furthermore
聪	聰	cōng 	quick at hearing  / wise  / clever  / sharp-witted  / intelligent  / acute
而		ér 	and  / as well as  / and so  / but (not)  / yet (not)  / (indicates causal relation)  / (indicates change of state)  / (indicates contrast)
且		qiě 	and  / moreover  / yet  / for the time being  / to be about to  / both (... and...)
春		Chūn <br /><br />chūn 	surname Chun<br /><br />spring (season)  / gay  / joyful  / youthful  / love  / lust  / life
乐	樂	Lè <br /><br />Yuè <br /><br />lè <br /><br />yuè 	surname Le<br /><br />surname Yue<br /><br />happy  / cheerful  / to laugh<br /><br />music
快乐	快樂	kuài lè 	happy  / merry
节日	節日	jié rì 	holiday  / festival  / CL: 個｜个
春节	春節	Chūn jié 	Spring Festival (Chinese New Year)
礼物	禮物	lǐ wù 	gift  / present  / CL: 件, 個｜个, 份
送		sòng 	to deliver  / to carry  / to give (as a present)  / to present (with)  / to see off  / to send
新年		xīn nián 	New Year  / CL: 個｜个
瓶		píng 	bottle  / vase  / pitcher  / CL: 個｜个 / classifier for wine and liquids
白酒		bái jiǔ 	baijiu, a spirit usually distilled from sorghum
礼	禮	Lǐ <br /><br />lǐ 	surname Li  / abbr. for 禮記｜礼记, Classic of Rites<br /><br />gift  / rite  / ceremony  / CL: 份 / propriety  / etiquette  / courtesy
物		wù 	thing  / object  / matter  / abbr. for physics 物理
过	過	Guò <br /><br />guò <br /><br />guo 	surname Guo<br /><br />to cross  / to go over  / to pass (time)  / to celebrate (a holiday)  / to live  / to get along  / excessively  / too-<br /><br />(experienced action marker)
干杯	乾杯	gān bēi 	to drink a toast  / Cheers! (proposing a toast)  / Here's to you!  / Bottoms up!  / lit. dry cup
祝		Zhù <br /><br />zhù 	surname Zhu<br /><br />to wish  / to express good wishes  / to pray  / (old) wizard
法国	法國	Fǎ guó 	France  / French
红酒		hóng jiǔ	Red wine
干	乾	Gān <br /><br />gān <br /><br />gān <br /><br />gàn 	surname Gan<br /><br />dry  / clean  / in vain  / dried food  / foster  / adoptive  / to ignore<br /><br />to concern  / to interfere  / shield  / stem<br /><br />tree trunk  / main part of sth  / to manage  / to work  / to do  / capable  / cadre  / to kill (slang)  / to fuck (vulgar)
法		Fǎ <br /><br />fǎ 	France  / French  / abbr. for 法國｜法国 / Taiwan pr. [Fa4]<br /><br />law  / method  / way  / Buddhist teaching  / Legalist
赛	賽	sài 	to compete  / competition  / match  / to surpass  / better than  / superior to  / to excel
练	練	liàn 	to practice  / to train  / to drill  / to perfect (one's skill)  / exercise
练习	練習	liàn xí 	to practice  / exercise  / drill  / practice  / CL: 個｜个
比赛	比賽	bǐ sài 	competition (sports etc)  / match  / CL: 場｜场, 次 / to compete
好在		hǎo zài 	luckily  / fortunately
乒乓球		pīng pāng qiú 	table tennis  / ping-pong  / table tennis ball  / CL: 個｜个
乒		pīng 	(onom.) ping  / bing
乓		pāng 	(onom.) bang
参加	參加	cān jiā 	to participate  / to take part  / to join
第		dì 	(prefix indicating ordinal number, e.g. first, number two etc)  / order  / (old) rank in the imperial examinations  / mansion  / (literary) but  / just
参	參	cān <br /><br />shēn 	to take part in  / to participate  / to join  / to attend  / to counsel  / unequal  / varied  / irregular  / uneven  / not uniform  / abbr. for 參議院｜参议院 Senate, Upper House<br /><br />ginseng  / one of the 28 constellations
网球	網球	wǎng qiú 	tennis  / tennis ball  / CL: 個｜个
排球		pái qiú 	volleyball  / CL: 個｜个
加油		jiā yóu 	to add oil  / to top up with gas  / to refuel  / to accelerate  / to step on the gas  / (fig.) to make an extra effort  / to cheer sb on
排		pái 	a row  / a line  / to set in order  / to arrange  / to line up  / to eliminate  / to drain  / to push open  / platoon  / raft  / classifier for lines, rows etc
油		yóu 	oil  / fat  / grease  / petroleum  / to apply tung oil, paint or varnish  / oily  / greasy  / glib  / cunning
输	輸	shū 	to lose  / to transport  / to donate  / to enter (a password)
赢	贏	yíng 	to beat  / to win  / to profit
失望		shī wàng 	disappointed  / to lose hope  / to despair
信心		xìn xīn 	confidence  / faith (in sb or sth)  / CL: 個｜个
失		shī 	to lose  / to miss  / to fail
信		xìn 	letter  / mail  / CL: 封 / to trust  / to believe  / to profess faith in  / truthful  / confidence  / trust  / at will  / at random
心		xīn 	heart  / mind  / intention  / center  / core  / CL: 顆｜颗, 個｜个
同	仝	tóng <br /><br />tóng <br /><br />tòng 	(used in given names)  / variant of 同<br /><br />like  / same  / similar  / together  / alike  / with<br /><br />see 衚衕｜胡同
课	課	kè 	subject  / course  / CL: 門｜门 / class  / lesson  / CL: 堂, 節｜节 / to levy  / tax  / form of divination
室		Shì <br /><br />shì 	surname Shi<br /><br />room  / work unit  / grave  / scabbard  / family or clan  / one of the 28 constellations of Chinese astronomy
教		Jiào <br /><br />jiāo <br /><br />jiào 	surname Jiao<br /><br />to teach<br /><br />religion  / teaching  / to make  / to cause  / to tell
教室		jiào shì 	classroom  / CL: 間｜间
同学	同學	tóng xué 	to study at the same school  / fellow student  / classmate  / CL: 位, 個｜个
地理		dì lǐ 	geography
理		lǐ 	texture  / grain (of wood)  / inner essence  / intrinsic order  / reason  / logic  / truth  / science  / natural science (esp. physics)  / to manage  / to pay attention to  / to run (affairs)  / to handle  / to put in order  / to tidy up
懂		dǒng 	to understand  / to comprehend
问题	問題	wèn tí 	question  / problem  / issue  / topic  / CL: 個｜个
笔	筆	bǐ 	pen  / pencil  / writing brush  / to write or compose  / the strokes of Chinese characters  / classifier for sums of money, deals  / CL: 支, 枝
题	題	Tí <br /><br />tí 	surname Ti<br /><br />topic  / problem for discussion  / exam question  / subject  / to inscribe  / to mention  / CL: 個｜个, 道
美术	美術	měi shù 	art  / fine arts  / painting  / CL: 種｜种
术	術	shù <br /><br />zhú 	method  / technique<br /><br />various genera of flowers of Asteracea family (daisies and chrysanthemums), including Atractylis lancea
上		shǎng <br /><br />shàng 	see 上聲｜上声<br /><br />on top  / upon  / above  / upper  / previous  / first (of multiple parts)  / to climb  / to get onto  / to go up  / to attend (class or university)
考试	考試	kǎo shì 	to take an exam  / exam  / CL: 次
题	題	Tí <br /><br />tí 	surname Ti<br /><br />topic  / problem for discussion  / exam question  / subject  / to inscribe  / to mention  / CL: 個｜个, 道
准备	準備	zhǔn bèi 	preparation  / to prepare  / to intend  / to be about to  / reserve (fund)
考	攷	kǎo <br /><br />kǎo 	to beat  / to hit  / variant of 考 / to inspect  / to test  / to take an exam<br /><br />to check  / to verify  / to test  / to examine  / to take an exam  / to take an entrance exam for  / deceased father
准		zhǔn <br /><br />zhǔn 	to allow  / to grant  / in accordance with  / in the light of<br /><br />accurate  / standard  / definitely  / certainly  / about to become (bride, son-in-law etc)  / quasi-  / para-
备	備	bèi 	to prepare  / get ready  / to provide or equip
科学	科學	kē xué 	science  / scientific knowledge  / scientific  / rational  / CL: 門｜门, 個｜个, 種｜种
科		kē 	branch of study  / administrative section  / division  / field  / branch  / stage directions  / family (taxonomy)  / rules  / laws  / to mete out (punishment)  / to levy (taxes etc)  / to fine sb  / CL: 個｜个
下课	下課	xià kè 	to finish class  / to get out of class
爷爷	爺爺	yé ye 	(coll.) father's father  / paternal grandfather  / CL: 個｜个
奶奶		nǎi nai 	(informal) grandma (paternal grandmother)  / (respectful) mistress of the house  / CL: 位 / (coll.) boobies  / breasts
阿姨		ā yí 	maternal aunt  / step-mother  / childcare worker  / nursemaid  / woman of similar age to one's parents (term of address used by child)  / CL: 個｜个
爷	爺	yé 	grandpa  / old gentleman
阿		Ā <br /><br />ā <br /><br />ē 	abbr. for Afghanistan 阿富汗<br /><br />prefix used before monosyllabic names, kinship terms etc to indicate familiarity  / used in transliteration  / also pr. [a4]<br /><br />flatter
姨		yí 	mother's sister  / aunt
兄弟姐妹		xiōng dì jiě mèi	Brothers and Sisters
关系	關係	guān xi 	relation  / relationship  / to concern  / to affect  / to have to do with  / guanxi  / CL: 個｜个
叔叔		shū shu 	father's younger brother  / uncle  / Taiwan pr. [shu2 shu5]  / CL: 個｜个
父母		fù mǔ 	father and mother  / parents
兄		xiōng 	elder brother
叔		shū 	uncle  / father's younger brother  / husband's younger brother  / Taiwan pr. [shu2]
父		fù 	father
母		mǔ 	mother  / elderly female relative  / origin  / source  / (of animals) female
像		xiàng 	to resemble  / to be like  / to look as if  / such as  / appearance  / image  / portrait  / image under a mapping (math.)
一样	一樣	yī yàng 	same  / like  / equal to  / the same as  / just like
亲戚	親戚	qīn qi 	a relative (i.e. family relation)  / CL: 門｜门, 個｜个, 位
戚		Qī <br /><br />qī 	surname Qi<br /><br />relative  / parent  / grief  / sorrow  / battle-axe
亲	親	qīn <br /><br />qìng 	parent  / one's own (flesh and blood)  / relative  / related  / marriage  / bride  / close  / intimate  / in person  / first-hand  / in favor of  / pro-  / to kiss  / (Internet slang) dear<br /><br />parents-in-law of one's offspring
拉面	拉麵	lā miàn 	pulled noodles  / ramen
点心	點心	diǎn xin 	light refreshments  / pastry  / dimsum (in Cantonese cooking)  / dessert
小笼包	小籠包	xiǎo lóng bāo 	steamed dumpling
拉		lā 	to pull  / to play (a bowed instrument)  / to drag  / to draw  / to chat
笼	籠	lóng <br /><br />lǒng 	enclosing frame made of bamboo, wire etc  / cage  / basket  / steamer basket  / to cover  / to cage  / to embrace  / to manipulate through trickery<br /><br />to cover  / to cage  / covering  / also pr. [long2]
粥		yù <br /><br />zhōu 	see 葷粥｜荤粥<br /><br />congee  / gruel  / porridge  / CL: 碗
油条	油條	yóu tiáo 	youtiao (deep-fried breadstick)  / CL: 根 / slick and sly person
豆浆	豆漿	dòu jiāng 	soy milk
油		yóu 	oil  / fat  / grease  / petroleum  / to apply tung oil, paint or varnish  / oily  / greasy  / glib  / cunning
豆		dòu 	bean  / pea  / CL: 棵, 粒 / sacrificial vessel
浆	漿	jiāng <br /><br />jiàng 	broth  / serum  / to starch<br /><br />starch paste
火锅	火鍋	huǒ guō 	hotpot
包子		bāo zi 	steamed stuffed bun  / CL: 個｜个
炒饭	炒飯	chǎo fàn 	fried rice  / (slang) (Tw) to have sex
锅	鍋	guō 	pot  / pan  / boiler  / CL: 口, 隻｜只
炒		chǎo 	to sauté  / to stir-fry  / to speculate  / to hype  / to fire (sb)
夏		Xià <br /><br />xià 	the Xia or Hsia dynasty c. 2000 BC  / Xia of the Sixteen Kingdoms (407-432)  / surname Xia<br /><br />summer
冬		dōng <br /><br />Dōng <br /><br />dōng 	winter<br /><br />surname Dong<br /><br />(onom.) beating a drum  / rat-a-tat
秋		Qiū <br /><br />qiū <br /><br />qiū 	surname Qiu<br /><br />autumn  / fall  / harvest time<br /><br />see 鞦韆｜秋千
春		Chūn <br /><br />chūn 	surname Chun<br /><br />spring (season)  / gay  / joyful  / youthful  / love  / lust  / life
后		Hòu <br /><br />hòu <br /><br />hòu 	surname Hou<br /><br />empress  / queen<br /><br />back  / behind  / rear  / afterwards  / after  / later
前		qián 	front  / forward  / ahead  / first  / top (followed by a number)  / future  / ago  / before  / BC (e.g. 前293年)  / former  / formerly
季		Jì <br /><br />jì 	surname Ji<br /><br />season  / the last month of a season  / fourth or youngest amongst brothers  / classifier for seasonal crop yields
澳		Ào <br /><br />ào 	abbr. for Macao 澳門｜澳门 / abbr. for Australia 澳大利亞｜澳大利亚<br /><br />deep bay  / cove  / harbor
亚	亞	yà 	Asia  / Asian  / second  / next to  / inferior  / sub-  / Taiwan pr. [ya3]
季节	季節	jì jié 	time  / season  / period  / CL: 個｜个
澳大利亚	澳大利亞	Ào dà lì yà 	Australia
越来越	越來越	yuè lái yuè 	more and more
前天		qián tiān 	the day before yesterday
后天	後天	hòu tiān 	the day after tomorrow  / acquired (not innate)  / a posteriori
堵车	堵車	dǔ chē 	traffic jam  / choking
大概		dà gài 	roughly  / probably  / rough  / approximate  / about  / general idea
准时	準時	zhǔn shí 	on time  / punctual  / on schedule
刚	剛	gāng 	hard  / firm  / strong  / just  / barely  / exactly
堵		dǔ 	to stop up  / (to feel) stifled or suffocated  / wall  / classifier for walls
概		gài 	general  / approximate
城		chéng 	city walls  / city  / town  / CL: 座, 道, 個｜个
市		shì 	market  / city  / CL: 個｜个
附		fù 	to add  / to attach  / to be close to  / to be attached
园	園	Yuán <br /><br />yuán 	surname Yuan<br /><br />land used for growing plants  / site used for public recreation
城市		chéng shì 	city  / town  / CL: 座
附近		fù jìn 	(in the) vicinity  / nearby  / neighboring  / next to
公园	公園	gōng yuán 	park (for public recreation)  / CL: 個｜个, 座
图	圖	tú 	diagram  / picture  / drawing  / chart  / map  / CL: 張｜张 / to plan  / to scheme  / to attempt  / to pursue  / to seek
馆	館	guǎn 	building  / shop  / term for certain service establishments  / embassy or consulate  / schoolroom (old)  / CL: 家
方		Fāng <br /><br />fāng 	surname Fang<br /><br />square  / power or involution (mathematics)  / upright  / honest  / fair and square  / direction  / side  / party (to a contract, dispute etc)  / place  / method  / prescription (medicine)  / just when  / only or just  / classifier for square things  / abbr. for square or cubic meter
中间	中間	zhōng jiān 	between  / intermediate  / mid  / middle
图书馆	圖書館	tú shū guǎn 	library  / CL: 家, 個｜个
地方		dì fāng <br /><br />dì fang 	region  / regional (away from the central administration)  / local<br /><br />area  / place  / space  / room  / territory  / CL: 處｜处, 個｜个, 塊｜块
上面		shàng miàn 	on top of  / above-mentioned  / also pr. [shang4 mian5]
下面		xià miàn <br /><br />xià miàn 	below  / under  / next  / the following  / also pr. [xia4 mian5]<br /><br />to boil noodles
咖啡馆	咖啡館	kā fēi guǎn 	café  / coffee shop  / CL: 家
折		shé <br /><br />zhē <br /><br />zhé 	to break (e.g. stick or bone)  / a loss<br /><br />to turn sth over  / to turn upside down  / to tip sth out (of a container)<br /><br />to break  / to fracture  / to snap  / to suffer loss  / to bend  / to twist  / to turn  / to change direction  / convinced  / to convert into (currency)  / discount  / rebate  / tenth (in price)  / classifier for theatrical scenes  / to fold  / accounts book
角		Jué <br /><br />jiǎo <br /><br />jué 	surname Jue<br /><br />angle  / corner  / horn  / horn-shaped  / unit of money equal to 0.1 yuan  / CL: 個｜个<br /><br />role (theater)  / to compete  / ancient three legged wine vessel  / third note of pentatonic scale
花		Huā <br /><br />huā 	surname Hua<br /><br />flower  / blossom  / CL: 朵, 支, 束, 把, 盆, 簇 / fancy pattern  / florid  / to spend (money, time)
打折		dǎ zhé 	to give a discount
旧	舊	jiù 	old  / opposite: new 新 / former  / worn (with age)
皮		Pí <br /><br />pí 	surname Pi<br /><br />leather  / skin  / fur  / CL: 張｜张 / pico- (one trillionth)  / naughty
换	換	huàn 	to exchange  / to change (clothes etc)  / to substitute  / to switch  / to convert (currency)
经	經	Jīng <br /><br />jīng 	surname Jing<br /><br />classics  / sacred book  / scripture  / to pass through  / to undergo  / to bear  / to endure  / warp (textile)  / longitude  / menstruation  / channel (TCM)  / abbr. for economics 經濟｜经济
皮鞋		pí xié 	leather shoes
经过	經過	jīng guò 	to pass  / to go through  / process  / course  / CL: 個｜个
退货	退貨	tuì huò 	to return merchandise  / to withdraw a product
退款		tuì kuǎn 	to refund  / refund
退		tuì 	to retreat  / to decline  / to move back  / to withdraw
货	貨	huò 	goods  / money  / commodity  / CL: 個｜个
款		kuǎn 	section  / paragraph  / funds  / CL: 筆｜笔, 個｜个 / classifier for versions or models (of a product)
袋子		dài zi 	bag
惯	慣	guàn 	accustomed to  / used to  / indulge  / to spoil (a child)
刷		shuā <br /><br />shuà 	to brush  / to paint  / to daub  / to paste up  / to skip class (of students)  / to fire from a job<br /><br />to select
牙		yá 	tooth  / ivory  / CL: 顆｜颗
习惯	習慣	xí guàn 	habit  / custom  / usual practice  / to be used to  / CL: 個｜个
刷牙		shuā yá 	to brush one's teeth
马上	馬上	mǎ shàng 	at once  / right away  / immediately  / on horseback (i.e. by military force)
以后	以後	yǐ hòu 	after  / later  / afterwards  / following  / later on  / in the future
澡		zǎo 	bath
总	總	zǒng 	always  / to assemble  / gather  / total  / overall  / head  / chief  / general  / in every case
洗澡		xǐ zǎo 	to bathe  / to take a shower
一边	一邊	yī biān 	one side  / either side  / on the one hand  / on the other hand  / doing while
总是	總是	zǒng shì 	always
讲	講	jiǎng 	to speak  / to explain  / to negotiate  / to emphasise  / to be particular about  / as far as sth is concerned  / speech  / lecture
故		gù 	happening  / instance  / reason  / cause  / intentional  / former  / old  / friend  / therefore  / hence  / (of people) to die, dead
故事		gù shì <br /><br />gù shi 	old practice  / CL: 個｜个<br /><br />narrative  / story  / tale
以前		yǐ qián 	before  / formerly  / previous  / ago
做梦	做夢	zuò mèng 	to dream  / to have a dream  / fig. illusion  / fantasy  / pipe dream
梦	夢	mèng 	dream  / CL: 場｜场, 個｜个
除		chú 	to get rid of  / to remove  / to exclude  / to eliminate  / to wipe out  / to divide  / except  / not including
其		qí 	his  / her  / its  / their  / that  / such  / it (refers to sth preceding it)
饺	餃	jiǎo 	dumplings with meat filling
北方		běi fāng 	north  / the northern part a country  / China north of the Yellow River
除了		chú le 	besides  / apart from (... also...)  / in addition to  / except (for)
其他		qí tā 	other  / (sth or sb) else  / the rest
饺子	餃子	jiǎo zi 	dumpling  / pot-sticker  / CL: 個｜个, 隻｜只
辣		là 	hot (spicy)  / pungent
极	極	jí 	extremely  / pole (geography, physics)  / utmost  / top
苦		kǔ 	bitter  / hardship  / pain  / to suffer  / to bring suffering to  / painstakingly
盐	鹽	yán 	salt  / CL: 粒
咸		Xián <br /><br />xián <br /><br />xián 	surname Xian<br /><br />all  / everyone  / each  / widespread  / harmonious<br /><br />salted  / salty  / stingy  / miserly
南		Nán <br /><br />nán 	surname Nan<br /><br />south
甜		tián 	sweet
南方		nán fāng 	south  / the southern part of the country  / the South
难吃	難吃	nán chī 	unpalatable
长	長	cháng <br /><br />zhǎng 	length  / long  / forever  / always  / constantly<br /><br />chief  / head  / elder  / to grow  / to develop  / to increase  / to enhance
级	級	jí 	level  / grade  / rank  / step (of stairs)  / CL: 個｜个 / classifier: step, level
个子	個子	gè zi 	height  / stature  / build  / size
年级	年級	nián jí 	grade  / year (in school, college etc)  / CL: 個｜个
小学	小學	xiǎo xué 	elementary school  / primary school  / CL: 個｜个
初中		chū zhōng 	junior high school  / abbr. for 初級中學｜初级中学
初		chū 	at first  / (at the) beginning  / first  / junior  / basic
轻	輕	qīng 	light  / easy  / gentle  / soft  / reckless  / unimportant  / frivolous  / small in number  / unstressed  / neutral  / to disparage
较	較	jiào 	to compare  / to dispute  / compared to  / (before adj.) relatively  / comparatively  / rather  / also pr. [jiao3]
年轻	年輕	nián qīng 	young
老		lǎo 	prefix used before the surname of a person or a numeral indicating the order of birth of the children in a family or to indicate affection or familiarity  / old (of people)  / venerable (person)  / experienced  / of long standing  / always  / all the time  / of the past  / very  / outdated  / (of meat etc) tough
比较	比較	bǐ jiào 	to compare  / to contrast  / comparatively  / relatively  / quite  / comparison
眼镜	眼鏡	yǎn jìng 	spectacles  / eyeglasses  / CL: 副
戴		Dài <br /><br />dài 	surname Dai<br /><br />to put on or wear (glasses, hat, gloves etc)  / to respect  / to bear  / to support
镜	鏡	jìng 	mirror  / lens
先		xiān 	early  / prior  / former  / in advance  / first
然后	然後	rán hòu 	after  / then (afterwards)  / after that  / afterwards
西边	西邊	xī biān 	west  / west side  / western part  / to the west of
东边	東邊	dōng bian 	east  / east side  / eastern part  / to the east of
前		qián 	front  / forward  / ahead  / first  / top (followed by a number)  / future  / ago  / before  / BC (e.g. 前293年)  / former  / formerly
左		Zuǒ <br /><br />zuǒ 	surname Zuo<br /><br />left  / the Left (politics)  / east  / unorthodox  / queer  / wrong  / differing  / opposite  / variant of 佐
北边	北邊	běi biān 	north  / north side  / northern part  / to the north of
一直		yī zhí 	straight (in a straight line)  / continuously  / always  / from the beginning of ... up to ...  / all along
最后	最後	zuì hòu 	final  / last  / finally  / ultimate
南边	南邊	nán bian 	south  / south side  / southern part  / to the south of
直		Zhí <br /><br />zhí 	surname Zhi  / Zhi (c. 2000 BC), fifth of the legendary Flame Emperors 炎帝 descended from Shennong 神農｜神农 Farmer God<br /><br />straight  / to straighten  / fair and reasonable  / frank  / straightforward  / (indicates continuing motion or action)  / vertical  / vertical downward stroke in Chinese characters
右		yòu 	right (-hand)  / the Right (politics)  / west (old)
后		Hòu <br /><br />hòu <br /><br />hòu 	surname Hou<br /><br />empress  / queen<br /><br />back  / behind  / rear  / afterwards  / after  / later
迷路		mí lù 	to lose the way  / lost  / labyrinth  / labyrinthus vestibularis (of the inner ear)
地址		dì zhǐ 	address  / CL: 個｜个
周围	周圍	zhōu wéi 	surroundings  / environment  / to encompass
迷		mí 	to bewilder  / crazy about  / fan  / enthusiast  / lost  / confused
址		zhǐ 	location  / site
围	圍	Wéi <br /><br />wéi 	surname Wei<br /><br />to encircle  / to surround  / all around  / to wear by wrapping around (scarf, shawl)
般		bān <br /><br />pán 	sort  / kind  / class  / way  / manner<br /><br />see 般樂｜般乐
聊		liáo 	to chat  / to depend upon (literary)  / temporarily  / just  / slightly
聊天		liáo tiān 	to chat  / to gossip
一般		yī bān 	same  / ordinary  / so-so  / common  / general  / generally  / in general
见面	見面	jiàn miàn 	to meet  / to see each other  / CL: 次
自己		zì jǐ 	oneself  / one's own
一个人	一個人	yī gè rén 	by oneself (without assistance)  / alone (without company)
自		zì 	self  / oneself  / from  / since  / naturally  / surely
己		jǐ 	self  / oneself  / sixth of the ten Heavenly Stems 十天干 / sixth in order  / letter "F" or roman "VI" in list "A, B, C", or "I, II, III" etc  / hexa
证	証	zhèng <br /><br />zhèng 	to admonish  / variant of 證｜证<br /><br />certificate  / proof  / to prove  / to demonstrate  / to confirm  / variant of 症
签	簽	qiān <br /><br />qiān 	to sign one's name  / visa  / variant of 籤｜签<br /><br />inscribed bamboo stick (used in divination, gambling, drawing lots etc)  / small wood sliver  / label  / tag
照		zhào 	according to  / in accordance with  / to shine  / to illuminate  / to reflect  / to look at (one's reflection)  / to take (a photo)  / photo  / as requested  / as before
护	護	hù 	to protect
护照	護照	hù zhào 	passport  / CL: 本, 個｜个
签证	簽證	qiān zhèng 	visa  / certificate  / to certify  / CL: 個｜个
发现	發現	fā xiàn 	to find  / to discover
起飞	起飛	qǐ fēi 	(of an aircraft) to take off
离开	離開	lí kāi 	to depart  / to leave
发	發	fā <br /><br />fà 	to send out  / to show (one's feeling)  / to issue  / to develop  / to make a bundle of money  / classifier for gunshots (rounds)<br /><br />hair  / Taiwan pr. [fa3]
检查	檢查	jiǎn chá 	inspection  / to examine  / to inspect  / CL: 次
行李		xíng li 	luggage  / CL: 件
安全		ān quán 	safe  / secure  / safety  / security
检	檢	jiǎn 	to check  / to examine  / to inspect  / to exercise restraint
查		Zhā <br /><br />chá <br /><br />zhā 	surname Zha<br /><br />to research  / to check  / to investigate  / to examine  / to refer to  / to look up (e.g. a word in a dictionary)<br /><br />see 山查
几乎	幾乎	jī hū 	almost  / nearly  / practically
忘记	忘記	wàng jì 	to forget
海关	海關	hǎi guān 	customs (i.e. border crossing inspection)  / CL: 個｜个
忘		wàng 	to forget  / to overlook  / to neglect
记	記	jì 	to record  / to note  / to memorize  / to remember  / mark  / sign  / classifier for blows, kicks, shots
几		jī <br /><br />jī <br /><br />jǐ 	small table<br /><br />almost<br /><br />how much  / how many  / several  / a few
乎		hū 	(classical particle similar to 於｜于) in  / at  / from  / because  / than  / (classical final particle similar to 嗎｜吗, 吧, 呢, expressing question, doubt or astonishment)
言		yán 	words  / speech  / to say  / to talk
易		Yì <br /><br />yì 	surname Yi  / abbr. for 易經｜易经, the Book of Changes<br /><br />easy  / amiable  / to change  / to exchange
容		Róng <br /><br />róng 	surname Rong<br /><br />to hold  / to contain  / to allow  / to tolerate  / appearance  / look  / countenance
种	種	zhǒng <br /><br />zhòng 	seed  / species  / kind  / type  / classifier for types, kinds, sorts<br /><br />to plant  / to grow  / to cultivate
容易		róng yì 	easy  / likely  / liable (to)
久		jiǔ 	(long) time  / (long) duration of time
语言	語言	yǔ yán 	language  / CL: 門｜门, 種｜种
学	學	xué 	to learn  / to study  / to imitate  / science  / -ology
更		gēng <br /><br />gèng 	to change or replace  / to experience  / one of the five two-hour periods into which the night was formerly divided  / watch (e.g. of a sentry or guard)<br /><br />more  / even more  / further  / still  / still more
努力		nǔ lì 	great effort  / to strive  / to try hard
汉字	漢字	hàn zì 	Chinese character  / CL: 個｜个 / Japanese: kanji  / Korean: hanja  / Vietnamese: hán tự
努		nǔ 	to exert  / to strive
力		Lì <br /><br />lì 	surname Li<br /><br />power  / force  / strength  / ability  / strenuously
提高		tí gāo 	to raise  / to increase  / to improve
水平		shuǐ píng 	level (of achievement etc)  / standard  / horizontal
后来	後來	hòu lái 	afterwards  / later
考	攷	kǎo <br /><br />kǎo 	to beat  / to hit  / variant of 考 / to inspect  / to test  / to take an exam<br /><br />to check  / to verify  / to test  / to examine  / to take an exam  / to take an entrance exam for  / deceased father
提		tí 	to carry (hanging down from the hand)  / to lift  / to put forward  / to mention  / to raise (an issue)  / upwards character stroke  / lifting brush stroke (in painting)  / scoop for measuring liquid
平		Píng <br /><br />píng 	surname Ping<br /><br />flat  / level  / equal  / to tie (make the same score)  / to draw (score)  / calm  / peaceful  / see also 平聲｜平声
看起来	看起來	kàn qǐ lai 	seemingly  / apparently  / looks as if  / appear to be  / gives the impression that  / seems on the face of it to be
奇怪		qí guài 	strange  / odd  / to marvel  / to be baffled
生气	生氣	shēng qì 	to get angry  / to take offense  / angry  / vitality  / liveliness
紧张	緊張	jǐn zhāng 	nervous  / keyed up  / intense  / tense  / strained  / in short supply  / scarce  / CL: 陣｜阵
奇		jī <br /><br />qí 	odd (number)<br /><br />strange  / odd  / weird  / wonderful  / surprisingly  / unusually
怪		guài 	bewildering  / odd  / strange  / uncanny  / devil  / monster  / to wonder at  / to blame  / quite  / rather
紧	緊	jǐn 	tight  / strict  / close at hand  / near  / urgent  / tense  / hard up  / short of money  / to tighten
难过	難過	nán guò 	to feel sad  / to feel unwell  / (of life) to be difficult
地		de <br /><br />dì 	-ly  / structural particle: used before a verb or adjective, linking it to preceding modifying adverbial adjunct<br /><br />earth  / ground  / field  / place  / land  / CL: 片
想		xiǎng 	to think  / to believe  / to suppose  / to wish  / to want  / to miss (feel wistful about the absence of sb or sth)
哭		kū 	to cry  / to weep
可怕		kě pà 	awful  / dreadful  / fearful  / formidable  / frightful  / scary  / hideous  / horrible  / terrible  / terribly
热情	熱情	rè qíng 	cordial  / enthusiastic  / passion  / passionate  / passionately
关心	關心	guān xīn 	to be concerned about  / to care about
经常	經常	jīng cháng 	frequently  / constantly  / regularly  / often  / day-to-day  / everyday  / daily
遇到		yù dào 	to meet  / to run into  / to come across
好笑		hǎo xiào 	laughable  / funny  / ridiculous
遇		Yù <br /><br />yù 	surname Yu<br /><br />to meet  / to encounter  / to treat  / to receive  / opportunity  / chance
求		qiú 	to seek  / to look for  / to request  / to demand  / to beseech
教		Jiào <br /><br />jiāo <br /><br />jiào 	surname Jiao<br /><br />to teach<br /><br />religion  / teaching  / to make  / to cause  / to tell
班		Bān <br /><br />bān 	surname Ban<br /><br />team  / class  / squad  / work shift  / ranking  / CL: 個｜个 / classifier for groups
校长	校長	xiào zhǎng 	(college, university) president  / headmaster  / CL: 個｜个, 位, 名
要求		yāo qiú 	to request  / to require  / requirement  / to stake a claim  / to ask  / to demand  / CL: 點｜点
食堂		shí táng 	dining hall  / CL: 個｜个, 間｜间
食		shí <br /><br />sì 	to eat  / food  / animal feed  / eclipse<br /><br />to feed
堂		táng 	(main) hall  / large room for a specific purpose  / CL: 間｜间 / relationship between cousins etc on the paternal side of a family  / of the same clan  / classifier for classes, lectures etc  / classifier for sets of furniture
必须	必須	bì xū 	to have to  / must  / compulsory  / necessarily
完成		wán chéng 	to complete  / to accomplish
作业	作業	zuò yè 	school assignment  / homework  / work  / task  / operation  / CL: 個｜个 / to operate
高中		gāo zhōng <br /><br />gāo zhòng 	senior high school  / abbr. for 高級中學｜高级中学<br /><br />to pass brilliantly (used in congratulatory fashion)
必		bì 	certainly  / must  / will  / necessarily
成		Chéng <br /><br />chéng 	surname Cheng<br /><br />to succeed  / to finish  / to complete  / to accomplish  / to become  / to turn into  / to be all right  / OK!  / one tenth
须	須	xū <br /><br />xū 	must  / to have to  / to wait<br /><br />beard  / mustache  / feeler (of an insect etc)  / tassel
业	業	Yè <br /><br />yè 	surname Ye<br /><br />line of business  / industry  / occupation  / job  / employment  / school studies  / enterprise  / property  / (Buddhism) karma  / deed  / to engage in  / already
向		Xiàng <br /><br />xiàng <br /><br />xiàng 	surname Xiang<br /><br />towards  / to face  / to turn towards  / direction  / to support  / to side with  / shortly before  / formerly  / always  / all along<br /><br />to tend toward  / to guide  / variant of 向
借		jiè 	to lend  / to borrow  / by means of  / to take (an opportunity)
笔记	筆記	bǐ jì 	to take down (in writing)  / notes  / a type of literature consisting mainly of short sketches  / CL: 本
铅笔	鉛筆	qiān bǐ 	(lead) pencil  / CL: 支, 枝, 桿｜杆
铅	鉛	qiān 	lead (chemistry)
纸	紙	zhǐ 	paper  / CL: 張｜张, 沓 / classifier for documents, letter etc
清楚		qīng chu 	clear  / distinct  / to understand thoroughly  / to be clear about
黑板		hēi bǎn 	blackboard  / CL: 塊｜块, 個｜个
笔记本	筆記本	bǐ jì běn 	notebook (stationery)  / CL: 本 / notebook (computing)
清		Qīng <br /><br />qīng 	Qing or Ch'ing dynasty of Imperial China (1644-1911)  / surname Qing<br /><br />clear  / distinct  / quiet  / just and honest  / pure  / to settle or clear up  / to clean up or purge
楚		Chǔ <br /><br />chǔ 	surname Chu  / abbr. for Hubei 湖北省 and Hunan 湖南省 provinces together  / Chinese kingdom during the Spring and Autumn and Warring States Periods (722-221 BC)<br /><br />distinct  / clear  / orderly  / pain  / suffering  / deciduous bush used in Chinese medicine (genus Vitex)  / punishment cane (old)
板		bǎn <br /><br />bǎn <br /><br />pàn 	board  / plank  / plate  / shutter  / table tennis bat  / clappers (music)  / CL: 塊｜块 / accented beat in Chinese music  / hard  / stiff  / to stop smiling or look serious<br /><br />see 老闆｜老板, boss<br /><br />to catch sight of in a doorway (old)
体育馆	體育館	tǐ yù guǎn 	gym  / gymnasium  / stadium  / CL: 個｜个
化		huà 	to make into  / to change into  / -ization  / to ... -ize  / to transform  / abbr. for 化學｜化学
算		suàn 	to regard as  / to figure  / to calculate  / to compute
搬		bān 	to move (i.e. relocate oneself)  / to move (sth relatively heavy or bulky)  / to shift  / to copy indiscriminately
变	變	biàn 	to change  / to become different  / to transform  / to vary  / rebellion
打算		dǎ suàn 	to plan  / to intend  / to calculate  / plan  / intention  / calculation  / CL: 個｜个
变化	變化	biàn huà 	change  / variation  / to change  / to vary  / CL: 個｜个
机会	機會	jī huì 	opportunity  / chance  / occasion  / CL: 個｜个
留学	留學	liú xué 	to study abroad
国家	國家	guó jiā 	country  / nation  / state  / CL: 個｜个
选择	選擇	xuǎn zé 	to select  / to pick  / choice  / option  / alternative
选	選	xuǎn 	to choose  / to pick  / to select  / to elect
择	擇	zé 	to select  / to choose  / to pick over  / to pick out  / to differentiate  / to eliminate  / also pr. [zhai2]
结婚	結婚	jié hūn 	to marry  / to get married  / CL: 次
愿意	願意	yuàn yì 	to wish  / to want  / ready  / willing (to do sth)
认真	認真	rèn zhēn 	conscientious  / earnest  / serious  / to take seriously  / to take to heart
结	結	jiē <br /><br />jié 	(of a plant) to produce (fruit or seeds)  / Taiwan pr. [jie2]<br /><br />knot  / sturdy  / bond  / to tie  / to bind  / to check out (of a hotel)
愿		yuàn <br /><br />yuàn 	honest  / prudent  / variant of 願｜愿<br /><br />to hope  / to wish  / to desire  / hoped-for  / ready  / willing
婚		hūn 	to marry  / marriage  / wedding  / to take a wife
当然	當然	dāng rán 	only natural  / as it should be  / certainly  / of course  / without doubt
放心		fàng xīn 	to feel relieved  / to feel reassured  / to be at ease
害怕		hài pà 	to be afraid  / to be scared
当	噹	dāng <br /><br />dāng <br /><br />dàng 	(onom.) dong  / ding dong (bell)<br /><br />to be  / to act as  / manage  / withstand  / when  / during  / ought  / should  / match equally  / equal  / same  / obstruct  / just at (a time or place)  / on the spot  / right  / just at<br /><br />at or in the very same...  / suitable  / adequate  / fitting  / proper  / to replace  / to regard as  / to think  / to pawn  / (coll.) to fail (a student)
害		hài 	to do harm to  / to cause trouble to  / harm  / evil  / calamity
怕		Pà <br /><br />pà 	surname Pa<br /><br />to be afraid  / to fear  / to dread  / to be unable to endure  / perhaps
分手		fēn shǒu 	to part company  / to split up  / to break up
境		jìng 	border  / place  / condition  / boundary  / circumstances  / territory
环	環	Huán <br /><br />huán 	surname Huan<br /><br />ring  / hoop  / loop  / (chain) link  / classifier for scores in archery etc  / to surround  / to encircle  / to hem in
层	層	céng 	layer  / stratum  / laminated  / floor (of a building)  / storey  / classifier for layers  / repeated  / sheaf (math.)
方便		fāng biàn 	convenient  / suitable  / to facilitate  / to make things easy  / having money to spare  / (euphemism) to relieve oneself
环境	環境	huán jìng 	environment  / circumstances  / surroundings  / CL: 個｜个 / ambient
花		Huā <br /><br />huā 	surname Hua<br /><br />flower  / blossom  / CL: 朵, 支, 束, 把, 盆, 簇 / fancy pattern  / florid  / to spend (money, time)
草		cǎo 	grass  / straw  / manuscript  / draft (of a document)  / careless  / rough  / CL: 棵, 撮, 株, 根
太阳	太陽	tài yang 	sun  / CL: 個｜个 / abbr. for 太陽穴｜太阳穴
星星		xīng xing 	star in the sky
阳	陽	yáng 	positive (electric.)  / sun  / male principle (Taoism)  / Yang, opposite: 陰｜阴 ☯
安静	安靜	ān jìng 	quiet  / peaceful  / calm
楼	樓	Lóu <br /><br />lóu 	surname Lou<br /><br />house with more than 1 story  / storied building  / floor  / CL: 層｜层, 座, 棟｜栋
上		shǎng <br /><br />shàng 	see 上聲｜上声<br /><br />on top  / upon  / above  / upper  / previous  / first (of multiple parts)  / to climb  / to get onto  / to go up  / to attend (class or university)
来	來	lái 	to come  / to arrive  / to come round  / ever since  / next
去		qù 	to go  / to go to (a place)  / (of a time etc) last  / just passed  / to send  / to remove  / to get rid of  / to reduce  / to be apart from in space or time  / to die (euphemism)  / to play (a part)  / (when used either before or after a verb) to go in order to do sth  / (after a verb of motion indicates movement away from the speaker)  / (used after certain verbs to indicate detachment or separation)
静	靜	jìng 	still  / calm  / quiet  / not moving
声音	聲音	shēng yīn 	voice  / sound  / CL: 個｜个
影响	影響	yǐng xiǎng 	influence  / effect  / to influence  / to affect (usually adversely)  / to disturb  / CL: 股
邻居	鄰居	lín jū 	neighbor  / next door  / CL: 個｜个
下		xià 	down  / downwards  / below  / lower  / later  / next (week etc)  / second (of two parts)  / to decline  / to go down  / to arrive at (a decision, conclusion etc)  / measure word to show the frequency of an action
声	聲	shēng 	sound  / voice  / tone  / noise  / classifier for sounds
邻	鄰	lín 	neighbor  / adjacent  / close to
响	響	xiǎng 	echo  / sound  / noise  / to make a sound  / to sound  / to ring  / loud  / classifier for noises
居		Jū <br /><br />jī <br /><br />jū 	surname Ju<br /><br />(archaic) sentence-final particle expressing a doubting attitude<br /><br />to reside  / to be (in a certain position)  / to store up  / to be at a standstill  / residence  / house  / restaurant  / classifier for bedrooms
垃圾		lā jī 	trash  / refuse  / garbage  / (coll.) of poor quality  / Taiwan pr. [le4 se4]
桶		tǒng 	bucket  / (trash) can  / barrel (of oil etc)  / CL: 個｜个, 隻｜只
丢	丟	diū 	to lose  / to put aside  / to throw
脏	臟	zàng <br /><br />zāng 	viscera  / (anatomy) organ<br /><br />dirty  / filthy
垃		lā 	see 垃圾 / Taiwan pr. [le4]
圾		jī 	see 垃圾 / Taiwan pr. [se4]
先生		Xiān sheng <br /><br />xiān sheng 	Mister (Mr.)<br /><br />teacher  / husband  / doctor (dialect)  / CL: 位
小姐		xiǎo jie 	young lady  / miss  / (slang) prostitute  / CL: 個｜个, 位
经理	經理	jīng lǐ 	manager  / director  / CL: 個｜个, 位, 名
同事		tóng shì 	colleague  / co-worker  / CL: 個｜个, 位
突然		tū rán 	sudden  / abrupt  / unexpected
重要		zhòng yào 	important  / significant  / major
会议	會議	huì yì 	meeting  / conference  / CL: 場｜场, 屆｜届
突		tū 	to dash  / to move forward quickly  / to bulge  / to protrude  / to break through  / to rush out  / sudden  / Taiwan pr. [tu2]
重		chóng <br /><br />zhòng 	to repeat  / repetition  / again  / re-  / classifier: layer<br /><br />heavy  / serious  / to attach importance to
议	議	yì 	to comment on  / to discuss  / to suggest
忘		wàng 	to forget  / to overlook  / to neglect
解决	解決	jiě jué 	to settle (a dispute)  / to resolve  / to solve  / to dispose of  / to dispatch
办法	辦法	bàn fǎ 	means  / method  / way (of doing sth)  / CL: 條｜条, 個｜个
相信		xiāng xìn 	to be convinced (that sth is true)  / to believe  / to accept sth as true
决	決	jué 	to decide  / to determine  / to execute (sb)  / (of a dam etc) to breach or burst  / definitely  / certainly
法		Fǎ <br /><br />fǎ 	France  / French  / abbr. for 法國｜法国 / Taiwan pr. [Fa4]<br /><br />law  / method  / way  / Buddhist teaching  / Legalist
相		Xiāng <br /><br />xiāng <br /><br />xiàng 	surname Xiang<br /><br />each other  / one another  / mutually<br /><br />appearance  / portrait  / picture  / government minister  / (physics) phase  / (literary) to appraise (esp. by scrutinizing physical features)  / to read sb's fortune (by physiognomy, palmistry etc)
解		Xiè <br /><br />jiě <br /><br />jiè <br /><br />xiè 	surname Xie<br /><br />to divide  / to break up  / to split  / to separate  / to dissolve  / to solve  / to melt  / to remove  / to untie  / to loosen  / to open  / to emancipate  / to explain  / to understand  / to know  / a solution  / a dissection<br /><br />to transport under guard<br /><br />acrobatic display (esp. on horseback) (old)  / variant of 懈 and 邂 (old)
界		jiè 	boundary  / scope  / extent  / circles  / group  / kingdom (taxonomy)
河		hé 	river  / CL: 條｜条, 道
世		Shì <br /><br />shì 	surname Shi<br /><br />life  / age  / generation  / era  / world  / lifetime  / epoch  / descendant  / noble
黄河	黃河	Huáng Hé 	Yellow River or Huang He
动物	動物	dòng wù 	animal  / CL: 隻｜只, 群, 個｜个
有名		yǒu míng 	famous  / well-known
世界		shì jiè 	world  / CL: 個｜个
长江	長江	Cháng Jiāng 	Yangtze River, or Chang Jiang
江		Jiāng <br /><br />jiāng 	surname Jiang<br /><br />river  / CL: 條｜条, 道
多么	多麼	duō me 	how (wonderful etc)  / what (a great idea etc)  / however (difficult it may be etc)  / (in interrogative sentences) how (much etc)  / to what extent
熊猫	熊貓	xióng māo 	panda  / CL: 隻｜只
西安		Xī ān 	Xi'an, sub-provincial city and capital of Shaanxi 陝西省｜陕西省 in northwest China  / see 西安區｜西安区
啊		ā <br /><br />á <br /><br />ǎ <br /><br />à <br /><br />a 	interjection of surprise  / Ah!  / Oh!<br /><br />interjection expressing doubt or requiring answer  / Eh?  / what?<br /><br />interjection of surprise or doubt  / Eh?  / My!  / what's up?<br /><br />interjection or grunt of agreement  / uhm  / Ah, OK  / expression of recognition  / Oh, it's you!<br /><br />modal particle ending sentence, showing affirmation, approval, or consent
熊		Xióng <br /><br />xióng 	surname Xiong<br /><br />bear  / to scold  / to rebuke  / brilliant light  / to shine brightly
长城	長城	Cháng chéng 	the Great Wall
故宫	故宮	Gù gōng <br /><br />gù gōng 	the Forbidden City  / abbr. for 故宮博物院｜故宫博物院<br /><br />former imperial palace
宫	宮	Gōng <br /><br />gōng 	surname Gong<br /><br />palace  / temple  / castration (as corporal punishment)  / first note in pentatonic scale
山		Shān <br /><br />shān 	surname Shan<br /><br />mountain  / hill  / anything that resembles a mountain  / CL: 座 / bundled straw in which silkworms spin cocoons  / gable
者		zhě 	(after a verb or adjective) one who (is) ...  / (after a noun) person involved in ...  / -er  / -ist  / (used after a number or 後｜后 or 前 to refer to sth mentioned previously)  / (used after a term, to mark a pause before defining the term)  / (old) (used at the end of a command)  / (old) this
爬		pá 	to crawl  / to climb  / to get up or sit up
或		huò 	maybe  / perhaps  / might  / possibly  / or
自行车	自行車	zì xíng chē 	bicycle  / bike  / CL: 輛｜辆
或者		huò zhě 	or  / possibly  / maybe  / perhaps
爬山		pá shān 	to climb a mountain  / to mountaineer  / hiking  / mountaineering
功夫		gōng fu 	skill  / art  / kung fu  / labor  / effort
功		gōng 	meritorious deed or service  / achievement  / result  / service  / accomplishment  / work (physics)
对	對	duì 	right  / correct  / couple  / pair  / towards  / at  / for  / to face  / opposite  / to treat (sb a certain way)  / to match together  / to adjust  / to fit  / to suit  / to answer  / to reply  / classifier: couple
文化		wén huà 	culture  / civilization  / cultural  / CL: 個｜个, 種｜种
历史	歷史	lì shǐ 	history  / CL: 門｜门, 段
兴趣	興趣	xìng qù 	interest (desire to know about sth)  / interest (thing in which one is interested)  / hobby  / CL: 個｜个
感兴趣	感興趣	gǎn xìng qù 	to be interested
历	曆	lì <br /><br />lì 	calendar<br /><br />to experience  / to undergo  / to pass through  / all  / each  / every  / history
趣		qù 	interesting  / to interest
史		Shǐ <br /><br />shǐ 	surname Shi<br /><br />history  / annals  / title of an official historian in ancient China
为了	為了	wèi le 	in order to  / for the purpose of  / so as to
特别	特別	tè bié 	especially  / special  / particular  / unusual
了解		liǎo jiě <br /><br />liǎo jiě 	to understand  / to realize  / to find out<br /><br />to understand  / to realize  / to find out
麻将	麻將	má jiàng 	mahjong  / CL: 副
特		tè 	special  / unique  / distinguished  / especially  / unusual  / very
麻		Má <br /><br />má 	surname Ma<br /><br />generic name for hemp, flax etc  / hemp or flax fiber for textile materials  / sesame  / CL: 縷｜缕 / (of materials) rough or coarse  / pocked  / pitted  / to have pins and needles or tingling  / to feel numb
将	將	jiāng <br /><br />jiàng <br /><br />qiāng 	will  / shall  / to use  / to take  / to checkmate  / just a short while ago  / (introduces object of main verb, used in the same way as 把)<br /><br />general  / commander-in-chief (military)  / king (chess piece)  / to command  / to lead<br /><br />to desire  / to invite  / to request
了		le <br /><br />liǎo <br /><br />liǎo 	(modal particle intensifying preceding clause)  / (completed action marker)<br /><br />to finish  / to achieve  / variant of 瞭｜了 / to understand clearly<br /><br />(of eyes) bright  / clear-sighted  / to understand clearly
顾	顧	Gù <br /><br />gù 	surname Gu<br /><br />to look after  / to take into consideration  / to attend to
死		sǐ 	to die  / impassable  / uncrossable  / inflexible  / rigid  / extremely  / damned
闷	悶	mēn <br /><br />mèn 	stuffy  / shut indoors  / to smother  / to cover tightly<br /><br />bored  / depressed  / melancholy  / sealed  / airtight  / tightly closed
腿		tuǐ <br /><br />tuǐ 	leg  / CL: 條｜条<br /><br />hip bone  / old variant of 腿
照		zhào 	according to  / in accordance with  / to shine  / to illuminate  / to reflect  / to look at (one's reflection)  / to take (a photo)  / photo  / as requested  / as before
照顾	照顧	zhào gu 	to take care of  / to show consideration  / to attend to  / to look after
公斤		gōng jīn 	kilogram (kg)
着急	著急	zháo jí 	to worry  / to feel anxious  / Taiwan pr. [zhao1 ji2]
瘦		shòu 	thin  / to lose weight  / (of clothing) tight  / (of meat) lean  / (of land) unproductive
斤		jīn 	catty  / (PRC) weight equal to 500 g  / (Tw) weight equal to 600 g  / (HK, Malaysia, Singapore) slightly over 604 g
急		jí 	urgent  / pressing  / rapid  / hurried  / worried  / to make (sb) anxious
着	著	zhāo <br /><br />zháo <br /><br />zhe <br /><br />zhuó 	(chess) move  / trick  / all right!  / (dialect) to add<br /><br />to touch  / to come in contact with  / to feel  / to be affected by  / to catch fire  / to burn  / (coll.) to fall asleep  / (after a verb) hitting the mark  / succeeding in<br /><br />aspect particle indicating action in progress<br /><br />to wear (clothes)  / to contact  / to use  / to apply
咳嗽		ké sou 	to cough  / CL: 陣｜阵
抽烟	抽煙	chōu yān 	to smoke (a cigarette, tobacco)
咳		hāi <br /><br />ké 	sound of sighing<br /><br />cough
嗽		sòu 	cough
抽		chōu 	to draw out  / to pull out from in between  / to remove part of the whole  / (of certain plants) to sprout or bud  / to whip or thrash
烟	煙	yān 	cigarette or pipe tobacco  / CL: 根 / smoke  / mist  / vapour  / CL: 縷｜缕 / tobacco plant  / (of the eyes) to be irritated by smoke
际	際	jì 	border  / edge  / boundary  / interval  / between  / inter-  / to meet  / time  / occasion  / to meet with (circumstances)
柜		jǔ <br /><br />guì 	Salix multinervis<br /><br />cupboard  / cabinet  / wardrobe
转	轉	zhuǎi <br /><br />zhuǎn <br /><br />zhuàn 	see 轉文｜转文<br /><br />to turn  / to change direction  / to transfer  / to forward (mail)<br /><br />to revolve  / to turn  / to circle about  / to walk about  / classifier for revolutions (per minute etc): revs, rpm  / classifier for repeated actions
转机	轉機	zhuǎn jī 	(to take) a turn for the better  / to change planes
柜台	櫃檯	guì tái 	sales counter  / front desk  / bar  / (of markets, medicines etc) OTC (over-the-counter)
国际	國際	guó jì 	international
换钱	換錢	huàn qián 	to change money  / to sell
银行	銀行	yín háng 	bank  / CL: 家, 個｜个
充电	充電	chōng diàn 	to recharge batteries  / fig. to rest and recuperate
国内	國內	guó nèi 	domestic  / internal (to a country)  / civil
银	銀	yín 	silver  / silver-colored  / relating to money or currency
充		chōng 	to fill  / to satisfy  / to fulfill  / to act in place of  / substitute  / sufficient  / full
内	內	nèi 	inside  / inner  / internal  / within  / interior
行		háng <br /><br />xíng 	row  / line  / commercial firm  / line of business  / profession  / to rank (first, second etc) among one's siblings (by age)  / (in data tables) row  / (Tw) column<br /><br />to walk  / to go  / to travel  / a visit  / temporary  / makeshift  / current  / in circulation  / to do  / to perform  / capable  / competent  / effective  / all right  / OK!  / will do  / behavior  / conduct  / Taiwan pr. [xing4] for the behavior-conduct sense
充值		chōng zhí 	to recharge (money onto a card)
漫游	漫遊	màn yóu 	to travel around  / to roam  / (mobile telephony) roaming
电话卡	電話卡	diàn huà kǎ 	telephone card
值		zhí 	value  / (to be) worth  / to happen to  / to be on duty
订房	訂房	dìng fáng 	to reserve a room
退房		tuì fáng 	to check out of a hotel room
取消		qǔ xiāo 	to cancel  / cancellation
导游	導遊	dǎo yóu 	tour guide  / guidebook  / to conduct a tour
订	訂	dìng 	to agree  / to conclude  / to draw up  / to subscribe to (a newspaper etc)  / to order
取		qǔ 	to take  / to get  / to choose  / to fetch
导	導	dǎo 	to transmit  / to lead  / to guide  / to conduct  / to direct
消		xiāo 	to disappear  / to vanish  / to eliminate  / to spend (time)  / have to  / need
答		dā <br /><br />dá 	to answer  / to agree<br /><br />reply  / answer  / return  / respond  / echo
句		jù 	sentence  / clause  / phrase  / classifier for phrases or lines of verse
单	單	Shàn <br /><br />dān 	surname Shan<br /><br />bill  / list  / form  / single  / only  / sole  / odd number  / CL: 個｜个
简	簡	jiǎn 	simple  / uncomplicated  / letter  / to choose  / to select  / bamboo strips used for writing (old)
简单	簡單	jiǎn dān 	simple  / not complicated
句子		jù zi 	sentence  / CL: 個｜个
回答		huí dá 	to reply  / to answer  / the answer  / CL: 個｜个
词典	詞典	cí diǎn 	dictionary (of Chinese compound words)  / also written 辭典｜辞典 / CL: 部, 本
应用	應用	yìng yòng 	to use  / to apply  / application  / applicable
语法	語法	yǔ fǎ 	grammar
流利		liú lì 	fluent
词	詞	cí 	word  / statement  / speech  / lyrics  / CL: 組｜组, 個｜个 / a form of lyric poetry, flourishing in the Song dynasty 宋朝 / CL: 首
流		liú 	to flow  / to disseminate  / to circulate or spread  / to move or drift  / to degenerate  / to banish or send into exile  / stream of water or sth resembling one  / class, rate or grade
利		Lì <br /><br />lì 	surname Li<br /><br />sharp  / favorable  / advantage  / benefit  / profit  / interest  / to do good to  / to benefit
典		diǎn 	canon  / law  / standard work of scholarship  / literary quotation or allusion  / ceremony  / to be in charge of  / to mortgage or pawn
应	應	Yìng <br /><br />yīng <br /><br />yìng 	surname Ying<br /><br />to agree (to do sth)  / should  / ought to  / must  / (legal) shall<br /><br />to answer  / to respond  / to comply with  / to deal or cope with
下载	下載	xià zǎi 	to download  / also pr. [xia4 zai4]
多邻国		duō lín guó	duolingo
翻译	翻譯	fān yì 	to translate  / to interpret  / translator  / interpreter  / translation  / interpretation  / CL: 個｜个, 位, 名
翻		fān 	to turn over  / to flip over  / to overturn  / to rummage through  / to translate  / to decode  / to double  / to climb over or into  / to cross
载	載	zǎi <br /><br />zài 	to record in writing  / to carry (i.e. publish in a newspaper etc)  / Taiwan pr. [zai4]  / year<br /><br />to carry  / to convey  / to load  / to hold  / to fill up  / and  / also  / as well as  / simultaneously
译	譯	yì 	to translate  / to interpret
把		bǎ <br /><br />bà 	to hold  / to contain  / to grasp  / to take hold of  / handle  / particle marking the following noun as a direct object  / classifier for objects with handle  / classifier for small objects: handful<br /><br />handle
灯	燈	dēng 	lamp  / light  / lantern  / CL: 盞｜盏
空调	空調	kōng tiáo 	air conditioning  / air conditioner (including units that have a heating mode)  / CL: 臺｜台
空		kōng <br /><br />kòng 	empty  / air  / sky  / in vain<br /><br />to empty  / vacant  / unoccupied  / space  / leisure  / free time
放		fàng 	to put  / to place  / to release  / to free  / to let go  / to let out  / to set off (fireworks)
画	畫	huà 	to draw  / picture  / painting  / CL: 幅, 張｜张 / classifier for paintings etc  / variant of 劃｜划
厨房	廚房	chú fáng 	kitchen  / CL: 間｜间
客厅	客廳	kè tīng 	drawing room (room for arriving guests)  / living room  / CL: 間｜间
厨	廚	chú 	kitchen
厅	廳	tīng 	(reception) hall  / living room  / office  / provincial government department
客人		kè rén 	visitor  / guest  / customer  / client  / CL: 位
打扫	打掃	dǎ sǎo 	to clean  / to sweep
干净	乾淨	gān jìng 	clean  / neat
扫	掃	sǎo <br /><br />sào 	to sweep<br /><br />broom
净	淨	jìng 	clean  / completely  / only  / net (income, exports etc)  / (Chinese opera) painted face male role
电梯	電梯	diàn tī 	elevator  / escalator  / CL: 臺｜台, 部
坏	壞	huài 	bad  / spoiled  / broken  / to break down  / (suffix) to the utmost
被		bèi 	quilt  / by  / (indicates passive-voice clauses)  / (literary) to cover  / to meet with
厕所	廁所	cè suǒ 	toilet  / lavatory  / CL: 間｜间, 處｜处
厕	廁	cè <br /><br />sì 	restroom  / toilet  / lavatory<br /><br />see 茅廁｜茅厕
梯		tī 	ladder  / stairs
寒		hán 	cold  / poor  / to tremble
暑		shǔ 	heat  / hot weather  / summer heat
复	復	fù <br /><br />fù 	to go and return  / to return  / to resume  / to return to a normal or original state  / to repeat  / again  / to recover  / to restore  / to turn over  / to reply  / to answer  / to reply to a letter  / to retaliate  / to carry out<br /><br />to repeat  / to double  / to overlap  / complex (not simple)  / compound  / composite  / double  / diplo-  / duplicate  / overlapping  / to duplicate
记得	記得	jì de 	to remember
复习	復習	fù xí 	to review  / revision  / CL: 次
数学	數學	shù xué 	mathematics  / mathematical
放假		fàng jià 	to have a holiday or vacation
暑假		shǔ jià 	summer vacation  / CL: 個｜个
寒假		hán jià 	winter vacation
终于	終於	zhōng yú 	at last  / in the end  / finally  / eventually
结束	結束	jié shù 	termination  / to finish  / to end  / to conclude  / to close
放松	放鬆	fàng sōng 	to loosen  / to relax
大学	大學	Dà xué <br /><br />dà xué 	the Great Learning, one of the Four Books 四書｜四书 in Confucianism<br /><br />university  / college  / CL: 所
终	終	zhōng 	end  / finish
结	結	jiē <br /><br />jié 	(of a plant) to produce (fruit or seeds)  / Taiwan pr. [jie2]<br /><br />knot  / sturdy  / bond  / to tie  / to bind  / to check out (of a hotel)
松		Sōng <br /><br />sōng <br /><br />sōng 	surname Song<br /><br />pine  / CL: 棵<br /><br />loose  / to loosen  / to relax
于		Yú <br /><br />yú <br /><br />yú 	surname Yu<br /><br />to go  / to take  / sentence-final interrogative particle  / variant of 於｜于<br /><br />in  / at  / to  / from  / by  / than  / out of
束		Shù <br /><br />shù 	surname Shu<br /><br />to bind  / bunch  / bundle  / classifier for bunches, bundles, beams of light etc  / to control
成绩	成績	chéng jì 	achievement  / performance records  / grades  / CL: 項｜项, 個｜个
担心	擔心	dān xīn 	anxious  / worried  / uneasy  / to worry  / to be anxious
为	為	wéi <br /><br />wèi 	as (in the capacity of)  / to take sth as  / to act as  / to serve as  / to behave as  / to become  / to be  / to do  / by (in the passive voice)<br /><br />because of  / for  / to
专业	專業	zhuān yè 	specialty  / specialized field  / main field of study (at university)  / major  / CL: 門｜门, 個｜个 / professional
成		Chéng <br /><br />chéng 	surname Cheng<br /><br />to succeed  / to finish  / to complete  / to accomplish  / to become  / to turn into  / to be all right  / OK!  / one tenth
担	擔	dān <br /><br />dàn 	to undertake  / to carry  / to shoulder  / to take responsibility<br /><br />picul (100 catties, 50 kg)  / two buckets full  / carrying pole and its load  / classifier for loads carried on a shoulder pole
专	專	zhuān 	for a particular person, occasion, purpose  / focused on one thing  / special  / expert  / particular (to sth)  / concentrated  / specialized
绩	績	jì 	to spin (hemp etc)  / merit  / accomplishment  / Taiwan pr. [ji1]
景		Jǐng <br /><br />jǐng 	surname Jing<br /><br />bright  / circumstance  / scenery
街		jiē 	street  / CL: 條｜条
地图	地圖	dì tú 	map  / CL: 張｜张, 本
拿		ná 	to hold  / to seize  / to catch  / to apprehend  / to take  / (used in the same way as 把: to mark the following noun as a direct object)
出		chū 	to go out  / to come out  / to occur  / to produce  / to go beyond  / to rise  / to put forth  / to happen  / (used after a verb to indicate an outward direction or a positive result)  / classifier for dramas, plays, operas etc
街道		jiē dào 	street  / CL: 條｜条 / subdistrict  / residential district
红绿灯	紅綠燈	hóng lǜ dēng 	traffic light  / traffic signal
风景	風景	fēng jǐng 	scenery  / landscape  / CL: 個｜个
司机	司機	sī jī 	chauffeur  / driver  / CL: 個｜个
接		jiē 	to receive  / to answer (the phone)  / to meet or welcome sb  / to connect  / to catch  / to join  / to extend  / to take one's turn on duty  / to take over for sb
免费	免費	miǎn fèi 	free (of charge)
打车	打車	dǎ chē 	to take a taxi (in town)  / to hitch a lift
观光	觀光	guān guāng 	to tour  / sightseeing  / tourism
免		miǎn 	to excuse sb  / to exempt  / to remove or dismiss from office  / to avoid  / to avert  / to escape  / to be prohibited
观	觀	Guàn <br /><br />guān <br /><br />guàn 	surname Guan<br /><br />to look at  / to watch  / to observe  / to behold  / to advise  / concept  / point of view  / outlook<br /><br />Taoist monastery  / palace gate watchtower  / platform
光		guāng 	light  / ray  / CL: 道 / bright  / only  / merely  / to use up
小心		xiǎo xīn 	to be careful  / to take care
过	過	Guò <br /><br />guò <br /><br />guo 	surname Guo<br /><br />to cross  / to go over  / to pass (time)  / to celebrate (a holiday)  / to live  / to get along  / excessively  / too-<br /><br />(experienced action marker)
时差	時差	shí chā 	time difference  / time lag  / jet lag
马路	馬路	mǎ lù 	street  / road  / CL: 條｜条
参观	參觀	cān guān 	to look around  / to tour  / to visit
博物馆	博物館	bó wù guǎn 	museum
博		bó 	extensive  / ample  / rich  / obtain  / aim  / to win  / to get  / plentiful  / to gamble
差		chā <br /><br />chà <br /><br />chāi 	difference  / discrepancy  / to differ  / error  / to err  / to make a mistake<br /><br />to differ from  / to fall short of  / lacking  / wrong  / inferior<br /><br />to send  / to commission  / messenger  / mission
安排		ān pái 	to arrange  / to plan  / to set up  / arrangements  / plans
活动	活動	huó dòng 	to exercise  / to move about  / to operate  / to use connections (personal influence)  / loose  / shaky  / active  / movable  / activity  / campaign  / maneuver  / behavior  / CL: 項｜项, 個｜个
表演		biǎo yǎn 	play  / show  / performance  / exhibition  / to perform  / to act  / to demonstrate  / CL: 場｜场
海边	海邊	hǎi biān 	coast  / seaside  / seashore  / beach
排		pái 	a row  / a line  / to set in order  / to arrange  / to line up  / to eliminate  / to drain  / to push open  / platoon  / raft  / classifier for lines, rows etc
活		huó 	to live  / alive  / living  / work  / workmanship
演		yǎn 	to develop  / to evolve  / to practice  / to perform  / to play  / to act
邮	郵	yóu 	post (office)  / mail
刚才	剛才	gāng cái <br /><br />gāng cái 	just now  / a moment ago<br /><br />(just) a moment ago
电子邮件	電子郵件	diàn zǐ yóu jiàn 	email  / CL: 封, 份
回		huí <br /><br />huí 	to circle  / to go back  / to turn around  / to answer  / to return  / to revolve  / Hui ethnic group (Chinese Muslims)  / time  / classifier for acts of a play  / section or chapter (of a classic book)<br /><br />to curve  / to return  / to revolve
发	發	fā <br /><br />fà 	to send out  / to show (one's feeling)  / to issue  / to develop  / to make a bundle of money  / classifier for gunshots (rounds)<br /><br />hair  / Taiwan pr. [fa3]
主要		zhǔ yào 	main  / principal  / major  / primary
短信		duǎn xìn 	text message  / SMS
关于	關於	guān yú 	pertaining to  / concerning  / with regard to  / about  / a matter of
主		zhǔ 	owner  / master  / host  / individual or party concerned  / God  / Lord  / main  / to indicate or signify  / trump card (in card games)
登录	登錄	dēng lù 	to register  / to log in
密码	密碼	mì mǎ 	secret code  / ciphertext  / password  / PIN
信号	信號	xìn hào 	signal
登		dēng 	to scale (a height)  / to ascend  / to mount  / to publish or record  / to enter (e.g. in a register)  / to press down with the foot  / to step or tread on  / to put on (shoes or trousers) (dialect)  / to be gathered and taken to the threshing ground (old)
密		Mì <br /><br />mì 	surname Mi  / name of an ancient state<br /><br />secret  / confidential  / close  / thick  / dense
码	碼	mǎ 	weight  / number  / code  / to pile  / to stack  / classifier for length or distance (yard), happenings etc
录	錄	Lù <br /><br />lù 	surname Lu<br /><br />diary  / record  / to hit  / to copy
段		Duàn <br /><br />duàn 	surname Duan<br /><br />paragraph  / section  / segment  / stage (of a process)  / classifier for stories, periods of time, lengths of thread etc
其实	其實	qí shí 	actually  / in fact  / really
过去	過去	guò qù <br /><br />guò qu 	(in the) past  / former  / previous  / to go over  / to pass by<br /><br />(verb suffix)
谈	談	Tán <br /><br />tán 	surname Tan<br /><br />to speak  / to talk  / to converse  / to chat  / to discuss
实	實	shí 	real  / true  / honest  / really  / solid  / fruit  / seed  / definitely
同意		tóng yì 	to agree  / to consent  / to approve
决定	決定	jué dìng 	to decide (to do something)  / to resolve  / decision  / CL: 個｜个, 項｜项 / certainly
根据	根據	gēn jù 	according to  / based on  / basis  / foundation  / CL: 個｜个
升职	升職	shēng zhí 	to get promoted (at work etc)  / promotion
定		dìng 	to set  / to fix  / to determine  / to decide  / to order
根		gēn 	root  / basis  / classifier for long slender objects, e.g. cigarettes, guitar strings  / CL: 條｜条 / radical (chemistry)
据		jū <br /><br />jù 	see 拮据<br /><br />according to  / to act in accordance with  / to depend on  / to seize  / to occupy
升		shēng 	to ascend  / to rise to the rank of  / to promote  / to hoist  / liter  / measure for dry grain equal to one-tenth dou 斗
职	職	zhí 	office  / duty
满意	滿意	mǎn yì 	satisfied  / pleased  / to one's satisfaction
认为	認為	rèn wéi 	to believe  / to think  / to consider  / to feel
出差		chū chāi 	to go on an official or business trip
表现	表現	biǎo xiàn 	to show  / to show off  / to display  / to manifest  / expression  / manifestation  / show  / display  / performance (at work etc)  / behavior
满	滿	Mǎn <br /><br />mǎn 	Manchu ethnic group<br /><br />to fill  / full  / filled  / packed  / fully  / completely  / quite  / to reach the limit  / to satisfy  / satisfied  / contented
为	為	wéi <br /><br />wèi 	as (in the capacity of)  / to take sth as  / to act as  / to serve as  / to behave as  / to become  / to be  / to do  / by (in the passive voice)<br /><br />because of  / for  / to
差		chā <br /><br />chà <br /><br />chāi 	difference  / discrepancy  / to differ  / error  / to err  / to make a mistake<br /><br />to differ from  / to fall short of  / lacking  / wrong  / inferior<br /><br />to send  / to commission  / messenger  / mission
老板	老闆	Lǎo bǎn <br /><br />lǎo bǎn 	Robam (brand)<br /><br />boss  / business proprietor  / CL: 個｜个
麻烦	麻煩	má fan 	inconvenient  / troublesome  / annoying  / to trouble or bother sb  / to put sb to trouble
开会	開會	kāi huì 	to hold a meeting  / to attend a meeting
面试	面試	miàn shì 	to be interviewed (as a candidate)  / interview
板		bǎn <br /><br />bǎn <br /><br />pàn 	board  / plank  / plate  / shutter  / table tennis bat  / clappers (music)  / CL: 塊｜块 / accented beat in Chinese music  / hard  / stiff  / to stop smiling or look serious<br /><br />see 老闆｜老板, boss<br /><br />to catch sight of in a doorway (old)
烦	煩	fán 	to feel vexed  / to bother  / to trouble  / superfluous and confusing  / edgy
饼	餅	bǐng 	round flat cake  / cookie  / cake  / pastry  / CL: 張｜张
园	園	Yuán <br /><br />yuán 	surname Yuan<br /><br />land used for growing plants  / site used for public recreation
月亮		yuè liang 	the moon
月饼	月餅	yuè bǐng 	mooncake (esp. for the Mid-Autumn Festival)
中秋节	中秋節	Zhōng qiū jié 	the Mid-Autumn Festival on 15th of 8th lunar month
圆	圓	yuán 	circle  / round  / circular  / spherical  / (of the moon) full  / unit of Chinese currency (Yuan)  / tactful  / to justify
恭喜		gōng xǐ 	congratulations  / greetings
红包	紅包	hóng bāo 	money wrapped in red as a gift  / bonus payment  / kickback  / bribe
汤圆	湯圓	tāng yuán 	boiled balls of glutinous rice flour, eaten during the Lantern Festival
聚会	聚會	jù huì 	party  / gathering  / to meet  / to get together
发财	發財	fā cái 	to get rich
恭		gōng 	respectful
聚		jù 	to congregate  / to assemble  / to mass  / to gather together  / to amass  / to polymerize
财	財	cái 	money  / wealth  / riches  / property  / valuables
端午节	端午節	Duān wǔ jié 	Dragon Boat Festival (5th day of the 5th lunar month)
粽子		zòng zi 	glutinous rice and choice of filling wrapped in leaves and boiled
划		huá <br /><br />huá <br /><br />huà 	to row  / to paddle  / profitable  / worth (the effort)  / it pays (to do sth)<br /><br />to cut  / to slash  / to scratch (cut into the surface of sth)  / to strike (a match)<br /><br />to delimit  / to transfer  / to assign  / to plan  / to draw (a line)  / stroke of a Chinese character
龙舟	龍舟	lóng zhōu 	dragon boat  / imperial boat
端		duān 	end  / extremity  / item  / port  / to hold sth level with both hands  / to carry  / regular
粽		zòng 	rice dumplings wrapped in leaves
龙	龍	Lóng <br /><br />lóng 	surname Long<br /><br />dragon  / CL: 條｜条 / imperial
舟		zhōu 	boat
珠		zhū 	bead  / pearl  / CL: 粒, 顆｜颗
汤	湯	Tāng <br /><br />shāng <br /><br />tāng 	surname Tang<br /><br />rushing current<br /><br />soup  / hot or boiling water  / decoction of medicinal herbs  / water in which sth has been boiled
酸		suān 	sour  / tart  / sick at heart  / grieved  / sore  / aching  / pedantic  / impractical  / an acid
珍		zhēn 	precious thing  / treasure  / culinary delicacy  / rare  / valuable  / to value highly
珍珠奶茶		zhēn zhū nǎi chá 	pearl milk tea  / tapioca milk tea  / bubble milk tea
酸辣汤	酸辣湯	suān là tāng 	hot and sour soup  / sour and spicy soup
北京烤鸭	北京烤鴨	Běi jīng kǎo yā 	Peking Duck
春卷	春捲	chūn juǎn 	egg roll  / spring roll
豆花		dòu huā 	jellied tofu  / soft bean curd
烤		kǎo 	to roast  / to bake  / to broil
鸭	鴨	yā 	duck  / CL: 隻｜只 / (slang) male prostitute
卷		juǎn <br /><br />juàn <br /><br />juǎn 	to roll up  / roll  / classifier for small rolled things (wad of paper money, movie reel etc)<br /><br />scroll  / book  / volume  / chapter  / examination paper  / classifier for books, paintings: volume, scroll<br /><br />to roll (up)  / to sweep up  / to carry on  / roll
宫保鸡丁	宮保雞丁	gōng bǎo jī dīng 	Kung Pao Chicken  / spicy diced chicken
卤肉饭		lǔ ròu fàn	Braised pork on rice
馒头	饅頭	mán tou 	steamed roll  / steamed bun  / steamed bread  / CL: 個｜个
保		Bǎo <br /><br />bǎo 	Bulgaria  / Bulgarian  / abbr. for 保加利亞｜保加利亚<br /><br />to defend  / to protect  / to keep  / to guarantee  / to ensure
卤	滷	lǔ <br /><br />lǔ 	to stew in soy sauce and spices<br /><br />alkaline soil  / salt  / brine  / halogen (chemistry)  / crass  / stupid
馒	饅	mán 	steamed bread
丁		Dīng <br /><br />dīng 	surname Ding<br /><br />fourth of the ten Heavenly Stems 十天干 / fourth in order  / letter "D" or roman "IV" in list "A, B, C", or "I, II, III" etc  / ancient Chinese compass point: 195°  / butyl  / cubes (of food)
豪		háo 	grand  / heroic
宅		zhái 	residence  / (coll.) to stay in at home  / to hang around at home
土		Tǔ <br /><br />tǔ 	Tu (ethnic group)  / surname Tu<br /><br />earth  / dust  / clay  / local  / indigenous  / crude opium  / unsophisticated  / one of the eight ancient musical instruments 八音
土豪		tǔ háo 	local tyrant  / local strong man  / (slang) nouveau riche
吃货	吃貨	chī huò 	chowhound  / foodie  / a good-for-nothing
宅男		zhái nán 	a guy who stays at home all the time, typically spending a lot of time playing online games (derived from Japanese "otaku")
菜鸟	菜鳥	cài niǎo 	(coll.) sb new to a particular subject  / rookie  / beginner  / newbie
美图		měi tú	
萌		méng 	to sprout  / to bud  / to have a strong affection for (slang)  / adorable (loanword from Japanese 萌え moe, slang describing affection for a cute character)
自拍		zì pāi 	to take a picture or video of oneself
囧		jiǒng	variant of 冏 / used as emoticon ("smiley") meaning embarrassed, sad :-(, depressed or frustrated 
美眉		měi méi 	(coll.) pretty girl
高富帅	高富帥	gāo fù shuài 	"Mr Perfect" (i.e. tall, rich and handsome) (Internet slang)
眉		méi 	eyebrow  / upper margin
富		Fù <br /><br />fù 	surname Fu<br /><br />rich  / abundant  / wealthy
刷		shuā <br /><br />shuà 	to brush  / to paint  / to daub  / to paste up  / to skip class (of students)  / to fire from a job<br /><br />to select
微博		wēi bó 	micro-blogging  / microblog
微信		Wēi xìn 	Weixin or WeChat (mobile text and voice messaging service developed by Tencent 騰訊｜腾讯)
朋友圈		Péng you quān 	Moments (social networking function of smartphone app WeChat 微信)
微		Wēi <br /><br />wēi 	surname Wei  / ancient Chinese state near present day Chongqing  / Taiwan pr. [Wei2]<br /><br />tiny  / miniature  / slightly  / profound  / abtruse  / to decline  / one millionth part of  / micro-  / Taiwan pr. [wei2]
圈		juān <br /><br />juàn <br /><br />quān 	to confine  / to lock up  / to pen in<br /><br />pen (pig)  / a fold<br /><br />circle  / ring  / loop  / classifier for loops, orbits, laps of race etc  / CL: 個｜个 / to surround  / to circle
关注	關注	guān zhù 	to pay attention to  / to follow sth closely  / concern  / interest  / attention
点	點	diǎn 	point  / dot  / drop  / speck  / o'clock  / point (in space or time)  / to draw a dot  / to check on a list  / to choose  / to order (food in a restaurant)  / to touch briefly  / to hint  / to light  / to ignite  / to pour a liquid drop by drop  / (old) one fifth of a two-hour watch 更 / dot stroke in Chinese characters  / classifier for items
赞	贊	zàn 	to patronize  / to support  / to praise  / (Internet slang) to like (an online post on Facebook etc)
转发	轉發	zhuǎn fā 	to transmit  / to forward (mail, SMS, packets of data)  / to pass on  / to republish (an article from another publication)
好友		hǎo yǒu 	close friend  / pal  / (social networking website) friend  / CL: 個｜个
加		Jiā <br /><br />jiā 	abbr. for Canada 加拿大 / surname Jia<br /><br />to add  / plus  / (used after an adverb such as 不, 大, 稍 etc, and before a disyllabic verb, to indicate that the action of the verb is applied to sth or sb previously mentioned)  / to apply (restrictions etc) to (sb)  / to give (support, consideration etc) to (sth)
粉丝	粉絲	fěn sī 	bean vermicelli  / mung bean starch noodles  / Chinese vermicelli  / cellophane noodles  / CL: 把 / fan (loanword)  / enthusiast for sb or sth
分享		fēn xiǎng 	to share (let others have some of sth good)
评论	評論	píng lùn 	to comment on  / to discuss  / comment  / commentary  / CL: 篇
粉		fěn 	powder  / cosmetic face powder  / food prepared from starch  / noodles or pasta made from any kind of flour  / whitewash  / white  / pink
丝	絲	sī 	silk  / thread  / trace  / (cuisine) shreds or julienne strips  / CL: 條｜条 / classifier: a thread (of cloud, smoke etc), a bit, an iota, a hint (of sth) etc
享		xiǎng 	to enjoy  / to benefit  / to have the use of
评	評	píng 	to discuss  / to comment  / to criticize  / to judge  / to choose (by public appraisal)
论	論	Lún <br /><br />lùn 	abbr. for 論語｜论语, The Analects (of Confucius)<br /><br />opinion  / view  / theory  / doctrine  / to discuss  / to talk about  / to regard  / to consider  / per  / by the (kilometer, hour etc)
销	銷	xiāo 	to melt (metal)  / to cancel or annul  / to sell  / to spend  / to fasten with a bolt  / bolt or pin
据		jū <br /><br />jù 	see 拮据<br /><br />according to  / to act in accordance with  / to depend on  / to seize  / to occupy
收据	收據	shōu jù 	receipt  / CL: 張｜张
报销	報銷	bào xiāo 	to submit an expense account  / to apply for reimbursement  / to write off  / to wipe out
费用	費用	fèi yòng 	cost  / expenditure  / expense  / CL: 筆｜笔, 個｜个
尽快	儘快	jǐn kuài <br /><br />jìn kuài 	as quickly as possible  / as soon as possible  / with all speed<br /><br />see 儘快｜尽快
回复	回復	huí fù 	to reply  / to recover  / to return (to a previous condition)  / Re: in reply to (email)
报告	報告	bào gào 	to inform  / to report  / to make known  / report  / speech  / talk  / lecture  / CL: 篇, 份, 個｜个, 通
协议	協議	xié yì 	agreement  / pact  / protocol  / CL: 項｜项
尽	儘	jǐn <br /><br />jìn 	to the greatest extent  / (when used before a noun of location) furthest or extreme  / to be within the limits of  / to give priority to<br /><br />to use up  / to exhaust  / to end  / to finish  / to the utmost  / exhausted  / finished  / to the limit (of sth)  / all  / entirely
协	協	xié 	to cooperate  / to harmonize  / to help  / to assist  / to join
议	議	yì 	to comment on  / to discuss  / to suggest
合同		hé tong 	(business) contract  / CL: 個｜个
项目	項目	xiàng mù 	item  / project  / (sports) event  / CL: 個｜个
签名	簽名	qiān míng 	to sign (one's name with a pen etc)  / to autograph  / signature
汇报	匯報	huì bào <br /><br />huì bào 	to report  / to give an account of  / to collect information and report back<br /><br />to report  / to give an account of  / report
合		gě <br /><br />hé 	100 ml  / one-tenth of a peck  / measure for dry grain equal to one-tenth of sheng 升 or liter, or one-hundredth dou 斗<br /><br />to close  / to join  / to fit  / to be equal to  / whole  / together  / round (in battle)  / conjunction (astronomy)  / 1st note of pentatonic scale  / old variant of 盒
项	項	Xiàng <br /><br />xiàng 	surname Xiang<br /><br />back of neck  / item  / thing  / term (in a mathematical formula)  / sum (of money)  / classifier for principles, items, clauses, tasks, research projects etc
汇	匯	huì <br /><br />huì 	to remit  / to converge (of rivers)  / to exchange<br /><br />class  / collection
广告	廣告	guǎng gào 	to advertise  / a commercial  / advertisement  / CL: 項｜项
预算	預算	yù suàn 	budget
资本	資本	zī běn 	capital (economics)
低		dī 	low  / beneath  / to lower (one's head)  / to let droop  / to hang down  / to incline
广	廣	Guǎng <br /><br />guǎng 	surname Guang<br /><br />wide  / numerous  / to spread
资	資	zī 	resources  / capital  / to provide  / to supply  / to support  / money  / expense
险	險	xiǎn 	danger  / dangerous  / rugged
投		tóu 	to cast  / to send  / to throw oneself (into the river etc)  / to seek refuge  / to place oneself into the hands of
保险	保險	bǎo xiǎn 	insurance  / to insure  / safe  / secure  / be sure  / be bound to  / CL: 份
风险	風險	fēng xiǎn 	risk  / hazard
投资	投資	tóu zī 	investment  / to invest
律师	律師	lǜ shī 	lawyer
版权	版權	bǎn quán 	copyright
咨询	咨詢	zī xún 	to consult  / to seek advice  / consultation  / (sales) inquiry (formal)
律		Lǜ <br /><br />lǜ 	surname Lü<br /><br />law
版		bǎn 	a register  / block of printing  / edition  / version  / page
咨		zī 	to consult
权	權	Quán <br /><br />quán 	surname Quan<br /><br />authority  / power  / right  / (literary) to weigh  / expedient  / temporary
询	詢	xún 	to ask about  / to inquire about
保持		bǎo chí 	to keep  / to maintain  / to hold  / to preserve
联系	聯繫	lián xì 	connection  / contact  / relation  / to get in touch with  / to integrate  / to link  / to touch
贵	貴	guì 	expensive  / noble  / precious  / (honorific) your
免		miǎn 	to excuse sb  / to exempt  / to remove or dismiss from office  / to avoid  / to avert  / to escape  / to be prohibited
联	聯	lián 	to ally  / to unite  / to join  / (poetry) antithetical couplet
持		chí 	to hold  / to grasp  / to support  / to maintain  / to persevere  / to manage  / to run (i.e. administer)  / to control
合作		hé zuò 	to cooperate  / to collaborate  / to work together  / cooperation  / CL: 個｜个
愉快		yú kuài 	cheerful  / cheerily  / delightful  / pleasant  / pleasantly  / pleasing  / happy  / delighted
辛苦		xīn kǔ 	exhausting  / hard  / tough  / arduous  / to work hard  / to go to a lot of trouble  / hardship(s)
感谢	感謝	gǎn xiè 	(express) thanks  / gratitude  / grateful  / thankful  / thanks
愉		yú 	pleased
辛		Xīn <br /><br />xīn 	surname Xin<br /><br />(of taste) hot or pungent  / hard  / laborious  / suffering  / eighth in order  / eighth of the ten Heavenly Stems 十天干 / letter "H" or roman "VIII" in list "A, B, C", or "I, II, III" etc  / ancient Chinese compass point: 285°  / octa
伤	傷	shāng 	to injure  / injury  / wound
受		shòu 	to receive  / to accept  / to suffer  / subjected to  / to bear  / to stand  / pleasant  / (passive marker)
护	護	hù 	to protect
救		jiù 	to save  / to assist  / to rescue
警		jǐng 	to alert  / to warn  / police
报警	報警	bào jǐng 	to sound an alarm  / to report sth to the police
救护车	救護車	jiù hù chē 	ambulance  / CL: 輛｜辆
受伤	受傷	shòu shāng 	to sustain injuries  / wounded (in an accident etc)  / harmed
救命		jiù mìng 	to save sb's life  / (interj.) Help!  / Save me!
发生	發生	fā shēng 	to happen  / to occur  / to take place  / to break out
意外		yì wài 	unexpected  / accident  / mishap  / CL: 個｜个
严重	嚴重	yán zhòng 	grave  / serious  / severe  / critical
严	嚴	Yán <br /><br />yán 	surname Yan<br /><br />tight (closely sealed)  / stern  / strict  / rigorous  / severe  / father
命		mìng 	life  / fate  / order or command  / to assign a name, title etc
偷		tōu 	to steal  / to pilfer  / to snatch  / thief  / stealthily
事		shì 	matter  / thing  / item  / work  / affair  / CL: 件, 樁｜桩, 回
警察		jǐng chá 	police  / police officer  / CL: 個｜个
察		Chá <br /><br />chá 	short name for Chahar Province 察哈爾｜察哈尔<br /><br />to examine  / to inquire  / to observe  / to inspect  / to look into  / obvious  / clearly evident
奖	獎	jiǎng 	prize  / award  / encouragement  / CL: 個｜个
工资	工資	gōng zī 	wages  / pay  / CL: 個｜个, 份, 月
加班		jiā bān 	to work overtime
奖金	獎金	jiǎng jīn 	premium  / award money  / bonus
生意		shēng yì <br /><br />shēng yi 	life force  / vitality<br /><br />business  / CL: 筆｜笔
压力	壓力	yā lì 	pressure
责任	責任	zé rèn 	responsibility  / blame  / duty  / CL: 個｜个
商量		shāng liang 	to consult  / to talk over  / to discuss
意见	意見	yì jiàn 	idea  / opinion  / suggestion  / objection  / complaint  / CL: 點｜点, 條｜条
压	壓	yā <br /><br />yà 	to press  / to push down  / to keep under (control)  / pressure<br /><br />see 壓根兒｜压根儿
责	責	zé 	duty  / responsibility  / to reproach  / to blame
任		Rén <br /><br />rèn 	surname Ren  / Ren County 任縣｜任县 in Hebei<br /><br />to assign  / to appoint  / to take up a post  / office  / responsibility  / to let  / to allow  / to give free rein to  / no matter (how, what etc)  / classifier for terms served in office, or for spouses, girlfriends etc (as in 前任男友)
误会	誤會	wù huì 	to misunderstand  / to mistake  / misunderstanding  / CL: 個｜个
抱歉		bào qiàn 	to be sorry  / to feel apologetic  / sorry!
原谅	原諒	yuán liàng 	to excuse  / to forgive  / to pardon
误	誤	wù 	mistake  / error  / to miss  / to harm  / to delay  / to neglect  / mistakenly
抱		bào 	to hold  / to carry (in one's arms)  / to hug  / to embrace  / to surround  / to cherish
原		Yuán <br /><br />yuán 	Hara (Japanese surname)<br /><br />former  / original  / primary  / raw  / level  / cause  / source
歉		qiàn 	to apologize  / to regret  / deficient
谅	諒	liàng 	to show understanding  / to excuse  / to presume  / to expect
干燥	乾燥	gān zào 	to dry (of weather, paint, cement etc)  / desiccation  / dull  / uninteresting  / arid
暖和		nuǎn huo 	warm  / nice and warm
凉快	涼快	liáng kuai 	nice and cold  / pleasantly cool
燥		zào 	dry  / parched  / impatient
暖		nuǎn 	warm  / to warm
和		Hé <br /><br />hé <br /><br />hè <br /><br />hú <br /><br />huó <br /><br />huò 	surname He  / Japanese (food, clothes etc)<br /><br />and  / together with  / with  / sum  / union  / peace  / harmony  / Taiwan pr. [han4] when it means "and" or "with"<br /><br />to compose a poem in reply (to sb's poem) using the same rhyme sequence  / to join in the singing  / to chime in with others<br /><br />to complete a set in mahjong or playing cards<br /><br />to combine a powdery substance (flour, plaster etc) with water  / Taiwan pr. [huo4]<br /><br />to mix (ingredients) together  / to blend  / classifier for rinses of clothes  / classifier for boilings of medicinal herbs
凉	涼	Liáng <br /><br />liáng <br /><br />liàng 	the five Liang of the Sixteen Kingdoms, namely: Former Liang 前涼｜前凉 (314-376), Later Liang 後涼｜后凉 (386-403), Northern Liang 北涼｜北凉 (398-439), Southern Liang 南涼｜南凉 (397-414), Western Liang 西涼｜西凉 (400-421)<br /><br />cool  / cold<br /><br />to let sth cool down
温度	溫度	wēn dù 	temperature  / CL: 個｜个
度		dù <br /><br />duó 	to pass  / to spend (time)  / measure  / limit  / extent  / degree of intensity  / degree (angles, temperature etc)  / kilowatt-hour  / classifier for events and occurrences<br /><br />to estimate  / Taiwan pr. [duo4]
大约	大約	dà yuē 	approximately  / probably
温	溫	Wēn <br /><br />wēn 	surname Wen<br /><br />warm  / lukewarm  / temperature  / to warm up  / mild  / soft  / tender  / to review (a lesson etc)  / fever (TCM)  / old variant of 瘟
鹰	鷹	yīng 	eagle  / falcon  / hawk
毛		Máo <br /><br />máo 	surname Mao<br /><br />hair  / feather  / down  / wool  / mildew  / mold  / coarse or semifinished  / young  / raw  / careless  / unthinking  / nervous  / scared  / (of currency) to devalue or depreciate  / classifier for Chinese fractional monetary unit ( = 角 , = one-tenth of a yuan or 10 fen 分)
羽		yǔ 	feather  / 5th note in pentatonic scale
橙		chéng 	orange tree  / orange (color)
猫头鹰	貓頭鷹	māo tóu yīng 	owl
羽毛		yǔ máo 	feather  / plumage  / plume
多儿		duō er	
鼓励	鼓勵	gǔ lì 	to encourage
提醒		tí xǐng 	to remind  / to call attention to  / to warn of
懒	懶	lǎn 	lazy
放弃	放棄	fàng qì 	to renounce  / to abandon  / to give up
鼓		gǔ 	drum  / CL: 通, 面 / to drum  / to strike  / to rouse  / to bulge  / to swell
励	勵	Lì <br /><br />lì 	surname Li<br /><br />to encourage  / to urge
醒		xǐng 	to wake up  / to be awake  / to become aware  / to sober up  / to come to
弃	棄	qì 	to abandon  / to relinquish  / to discard  / to throw away
